,Date,Tm,Opp,Result,MP,FG,FGA,FG%,2P,2PA,2P%,3P,3PA,3P%,FT,FTA,FT%,PTS,FG,FGA,FG%,2P,2PA,2P%,3P,3PA,3P%,FT,FTA,FT%,PTS
0,2021/3/13,ATL,SAC,W 121-106,240,43,84,0.512,31,51,0.608,12,33,0.364,23,33,0.697,121,43,98,0.439,36,62,0.581,7,36,0.194,13,16,0.813,106
1,2021/3/13,SAC,ATL,L 106-121,240,43,98,0.439,36,62,0.581,7,36,0.194,13,16,0.813,106,43,84,0.512,31,51,0.608,12,33,0.364,23,33,0.697,121
2,2021/3/13,BRK,DET,W 100-95,240,39,81,0.481,33,54,0.611,6,27,0.222,16,22,0.727,100,36,89,0.404,28,57,0.491,8,32,0.25,15,20,0.75,95
3,2021/3/13,DET,BRK,L 95-100,240,36,89,0.404,28,57,0.491,8,32,0.25,15,20,0.75,95,39,81,0.481,33,54,0.611,6,27,0.222,16,22,0.727,100
4,2021/3/13,CHO,TOR,W 114-104,240,39,80,0.488,18,31,0.581,21,49,0.429,15,19,0.789,114,37,96,0.385,22,50,0.44,15,46,0.326,15,18,0.833,104
5,2021/3/13,TOR,CHO,L 104-114,240,37,96,0.385,22,50,0.44,15,46,0.326,15,18,0.833,104,39,80,0.488,18,31,0.581,21,49,0.429,15,19,0.789,114
6,2021/3/13,DAL,DEN,W 116-103,240,42,86,0.488,24,40,0.6,18,46,0.391,14,16,0.875,116,37,90,0.411,21,49,0.429,16,41,0.39,13,18,0.722,103
7,2021/3/13,DEN,DAL,L 103-116,240,37,90,0.411,21,49,0.429,16,41,0.39,13,18,0.722,103,42,86,0.488,24,40,0.6,18,46,0.391,14,16,0.875,116
8,2021/3/13,MIN,POR,L 121-125,240,44,86,0.512,34,60,0.567,10,26,0.385,23,31,0.742,121,43,89,0.483,30,49,0.612,13,40,0.325,26,30,0.867,125
9,2021/3/13,POR,MIN,W 125-121,240,43,89,0.483,30,49,0.612,13,40,0.325,26,30,0.867,125,44,86,0.512,34,60,0.567,10,26,0.385,23,31,0.742,121
10,2021/3/13,NYK,OKC,W 119-97,240,44,91,0.484,30,56,0.536,14,35,0.4,17,22,0.773,119,37,76,0.487,29,44,0.659,8,32,0.25,15,21,0.714,97
11,2021/3/13,OKC,NYK,L 97-119,240,37,76,0.487,29,44,0.659,8,32,0.25,15,21,0.714,97,44,91,0.484,30,56,0.536,14,35,0.4,17,22,0.773,119
12,2021/3/13,IND,PHO,W 122-111,240,46,87,0.529,33,59,0.559,13,28,0.464,17,21,0.81,122,43,91,0.473,31,60,0.517,12,31,0.387,13,17,0.765,111
13,2021/3/13,PHO,IND,L 111-122,240,43,91,0.473,31,60,0.517,12,31,0.387,13,17,0.765,111,46,87,0.529,33,59,0.559,13,28,0.464,17,21,0.81,122
14,2021/3/13,MIL,WAS,W 125-119,240,43,99,0.434,26,54,0.481,17,45,0.378,22,25,0.88,125,43,94,0.457,27,53,0.509,16,41,0.39,17,22,0.773,119
15,2021/3/13,WAS,MIL,L 119-125,240,43,94,0.457,27,53,0.509,16,41,0.39,17,22,0.773,119,43,99,0.434,26,54,0.481,17,45,0.378,22,25,0.88,125
16,2021/3/12,CHI,MIA,L 90-101,240,34,91,0.374,19,53,0.358,15,38,0.395,7,7,1,90,37,80,0.463,25,45,0.556,12,35,0.343,15,20,0.75,101
17,2021/3/12,MIA,CHI,W 101-90,240,37,80,0.463,25,45,0.556,12,35,0.343,15,20,0.75,101,34,91,0.374,19,53,0.358,15,38,0.395,7,7,1,90
18,2021/3/12,IND,LAL,L 100-105,240,37,88,0.42,29,52,0.558,8,36,0.222,18,21,0.857,100,34,76,0.447,27,54,0.5,7,22,0.318,30,39,0.769,105
19,2021/3/12,LAL,IND,W 105-100,240,34,76,0.447,27,54,0.5,7,22,0.318,30,39,0.769,105,37,88,0.42,29,52,0.558,8,36,0.222,18,21,0.857,100
20,2021/3/12,DEN,MEM,W 103-102,240,41,92,0.446,28,55,0.509,13,37,0.351,8,11,0.727,103,40,87,0.46,26,59,0.441,14,28,0.5,8,8,1,102
21,2021/3/12,MEM,DEN,L 102-103,240,40,87,0.46,26,59,0.441,14,28,0.5,8,8,1,102,41,92,0.446,28,55,0.509,13,37,0.351,8,11,0.727,103
22,2021/3/12,CLE,NOP,L 82-116,240,30,88,0.341,23,56,0.411,7,32,0.219,15,20,0.75,82,47,101,0.465,41,77,0.532,6,24,0.25,16,19,0.842,116
23,2021/3/12,NOP,CLE,W 116-82,240,47,101,0.465,41,77,0.532,6,24,0.25,16,19,0.842,116,30,88,0.341,23,56,0.411,7,32,0.219,15,20,0.75,82
24,2021/3/12,ORL,SAS,L 77-104,240,29,80,0.363,19,42,0.452,10,38,0.263,9,12,0.75,77,40,89,0.449,30,60,0.5,10,29,0.345,14,18,0.778,104
25,2021/3/12,SAS,ORL,W 104-77,240,40,89,0.449,30,60,0.5,10,29,0.345,14,18,0.778,104,29,80,0.363,19,42,0.452,10,38,0.263,9,12,0.75,77
26,2021/3/12,HOU,UTA,L 99-114,240,41,111,0.369,32,68,0.471,9,43,0.209,8,13,0.615,99,39,81,0.481,24,41,0.585,15,40,0.375,21,25,0.84,114
27,2021/3/12,UTA,HOU,W 114-99,240,39,81,0.481,24,41,0.585,15,40,0.375,21,25,0.84,114,41,111,0.369,32,68,0.471,9,43,0.209,8,13,0.615,99
28,2021/3/12,PHI,WAS,W 127-101,240,49,90,0.544,38,69,0.551,11,21,0.524,18,18,1,127,40,82,0.488,32,58,0.552,8,24,0.333,13,22,0.591,101
29,2021/3/12,WAS,PHI,L 101-127,240,40,82,0.488,32,58,0.552,8,24,0.333,13,22,0.591,101,49,90,0.544,38,69,0.551,11,21,0.524,18,18,1,127
30,2021/3/11,BOS,BRK,L 109-121,240,41,91,0.451,28,51,0.549,13,40,0.325,14,22,0.636,109,42,88,0.477,23,46,0.5,19,42,0.452,18,22,0.818,121
31,2021/3/11,BRK,BOS,W 121-109,240,42,88,0.477,23,46,0.5,19,42,0.452,18,22,0.818,121,41,91,0.451,28,51,0.549,13,40,0.325,14,22,0.636,109
32,2021/3/11,CHI,PHI,L 105-127,240,39,83,0.47,25,54,0.463,14,29,0.483,13,16,0.813,105,53,103,0.515,43,70,0.614,10,33,0.303,11,15,0.733,127
33,2021/3/11,PHI,CHI,W 127-105,240,53,103,0.515,43,70,0.614,10,33,0.303,11,15,0.733,127,39,83,0.47,25,54,0.463,14,29,0.483,13,16,0.813,105
34,2021/3/11,CHO,DET,W 105-102,240,36,90,0.4,26,60,0.433,10,30,0.333,23,24,0.958,105,38,85,0.447,23,39,0.59,15,46,0.326,11,14,0.786,102
35,2021/3/11,DET,CHO,L 102-105,240,38,85,0.447,23,39,0.59,15,46,0.326,11,14,0.786,102,36,90,0.4,26,60,0.433,10,30,0.333,23,24,0.958,105
36,2021/3/11,GSW,LAC,L 104-130,240,38,88,0.432,29,52,0.558,9,36,0.25,19,27,0.704,104,44,96,0.458,26,55,0.473,18,41,0.439,24,29,0.828,130
37,2021/3/11,LAC,GSW,W 130-104,240,44,96,0.458,26,55,0.473,18,41,0.439,24,29,0.828,130,38,88,0.432,29,52,0.558,9,36,0.25,19,27,0.704,104
38,2021/3/11,MIA,ORL,W 111-103,240,41,91,0.451,25,42,0.595,16,49,0.327,13,22,0.591,111,39,96,0.406,27,62,0.435,12,34,0.353,13,15,0.867,103
39,2021/3/11,ORL,MIA,L 103-111,240,39,96,0.406,27,62,0.435,12,34,0.353,13,15,0.867,103,41,91,0.451,25,42,0.595,16,49,0.327,13,22,0.591,111
40,2021/3/11,MIL,NYK,W 134-101,240,50,87,0.575,32,49,0.653,18,38,0.474,16,17,0.941,134,37,88,0.42,24,51,0.471,13,37,0.351,14,21,0.667,101
41,2021/3/11,NYK,MIL,L 101-134,240,37,88,0.42,24,51,0.471,13,37,0.351,14,21,0.667,101,50,87,0.575,32,49,0.653,18,38,0.474,16,17,0.941,134
42,2021/3/11,MIN,NOP,W 135-105,240,51,95,0.537,32,55,0.582,19,40,0.475,14,16,0.875,135,43,100,0.43,37,68,0.544,6,32,0.188,13,24,0.542,105
43,2021/3/11,NOP,MIN,L 105-135,240,43,100,0.43,37,68,0.544,6,32,0.188,13,24,0.542,105,51,95,0.537,32,55,0.582,19,40,0.475,14,16,0.875,135
44,2021/3/11,DAL,OKC,L 108-116,240,35,82,0.427,20,48,0.417,15,34,0.441,23,33,0.697,108,41,91,0.451,25,59,0.424,16,32,0.5,18,20,0.9,116
45,2021/3/11,OKC,DAL,W 116-108,240,41,91,0.451,25,59,0.424,16,32,0.5,18,20,0.9,116,35,82,0.427,20,48,0.417,15,34,0.441,23,33,0.697,108
46,2021/3/11,PHO,POR,W 127-121,240,49,83,0.59,36,59,0.61,13,24,0.542,16,19,0.842,127,43,94,0.457,25,51,0.49,18,43,0.419,17,19,0.895,121
47,2021/3/11,POR,PHO,L 121-127,240,43,94,0.457,25,51,0.49,18,43,0.419,17,19,0.895,121,49,83,0.59,36,59,0.61,13,24,0.542,16,19,0.842,127
48,2021/3/11,HOU,SAC,L 105-125,240,41,99,0.414,30,54,0.556,11,45,0.244,12,17,0.706,105,45,92,0.489,34,59,0.576,11,33,0.333,24,28,0.857,125
49,2021/3/11,SAC,HOU,W 125-105,240,45,92,0.489,34,59,0.576,11,33,0.333,24,28,0.857,125,41,99,0.414,30,54,0.556,11,45,0.244,12,17,0.706,105
50,2021/3/11,ATL,TOR,W 121-120,240,39,90,0.433,24,48,0.5,15,42,0.357,28,35,0.8,121,42,96,0.438,25,59,0.424,17,37,0.459,19,23,0.826,120
51,2021/3/11,TOR,ATL,L 120-121,240,42,96,0.438,25,59,0.424,17,37,0.459,19,23,0.826,120,39,90,0.433,24,48,0.5,15,42,0.357,28,35,0.8,121
52,2021/3/10,DAL,SAS,W 115-104,240,43,83,0.518,30,43,0.698,13,40,0.325,16,19,0.842,115,38,83,0.458,26,55,0.473,12,28,0.429,16,20,0.8,104
53,2021/3/10,SAS,DAL,L 104-115,240,38,83,0.458,26,55,0.473,12,28,0.429,16,20,0.8,104,43,83,0.518,30,43,0.698,13,40,0.325,16,19,0.842,115
54,2021/3/10,MEM,WAS,W 127-112,240,50,99,0.505,42,76,0.553,8,23,0.348,19,29,0.655,127,38,95,0.4,27,59,0.458,11,36,0.306,25,27,0.926,112
55,2021/3/10,WAS,MEM,L 112-127,240,38,95,0.4,27,59,0.458,11,36,0.306,25,27,0.926,112,50,99,0.505,42,76,0.553,8,23,0.348,19,29,0.655,127
56,2021/3/4,BOS,TOR,W 132-125,240,45,74,0.608,32,45,0.711,13,29,0.448,29,40,0.725,132,45,91,0.495,24,41,0.585,21,50,0.42,14,17,0.824,125
57,2021/3/4,TOR,BOS,L 125-132,240,45,91,0.495,24,41,0.585,21,50,0.42,14,17,0.824,125,45,74,0.608,32,45,0.711,13,29,0.448,29,40,0.725,132
58,2021/3/4,DEN,IND,W 113-103,240,45,77,0.584,33,49,0.673,12,28,0.429,11,16,0.688,113,41,90,0.456,27,51,0.529,14,39,0.359,7,12,0.583,103
59,2021/3/4,IND,DEN,L 103-113,240,41,90,0.456,27,51,0.529,14,39,0.359,7,12,0.583,103,45,77,0.584,33,49,0.673,12,28,0.429,11,16,0.688,113
60,2021/3/4,MEM,MIL,L 111-112,240,40,101,0.396,32,67,0.478,8,34,0.235,23,24,0.958,111,42,95,0.442,32,61,0.525,10,34,0.294,18,22,0.818,112
61,2021/3/4,MIL,MEM,W 112-111,240,42,95,0.442,32,61,0.525,10,34,0.294,18,22,0.818,112,40,101,0.396,32,67,0.478,8,34,0.235,23,24,0.958,111
62,2021/3/4,MIA,NOP,W 103-93,240,36,73,0.493,26,43,0.605,10,30,0.333,21,25,0.84,103,33,84,0.393,22,41,0.537,11,43,0.256,16,20,0.8,93
63,2021/3/4,NOP,MIA,L 93-103,240,33,84,0.393,22,41,0.537,11,43,0.256,16,20,0.8,93,36,73,0.493,26,43,0.605,10,30,0.333,21,25,0.84,103
64,2021/3/4,DET,NYK,L 104-114,240,39,80,0.488,25,44,0.568,14,36,0.389,12,15,0.8,104,45,83,0.542,36,56,0.643,9,27,0.333,15,19,0.789,114
65,2021/3/4,NYK,DET,W 114-104,240,45,83,0.542,36,56,0.643,9,27,0.333,15,19,0.789,114,39,80,0.488,25,44,0.568,14,36,0.389,12,15,0.8,104
66,2021/3/4,GSW,PHO,L 98-120,240,38,88,0.432,26,53,0.491,12,35,0.343,10,16,0.625,98,49,96,0.51,37,66,0.561,12,30,0.4,10,13,0.769,120
67,2021/3/4,PHO,GSW,W 120-98,240,49,96,0.51,37,66,0.561,12,30,0.4,10,13,0.769,120,38,88,0.432,26,53,0.491,12,35,0.343,10,16,0.625,98
68,2021/3/4,POR,SAC,W 123-119,240,42,88,0.477,27,50,0.54,15,38,0.395,24,25,0.96,123,49,103,0.476,38,74,0.514,11,29,0.379,10,16,0.625,119
69,2021/3/4,SAC,POR,L 119-123,240,49,103,0.476,38,74,0.514,11,29,0.379,10,16,0.625,119,42,88,0.477,27,50,0.54,15,38,0.395,24,25,0.96,123
70,2021/3/4,OKC,SAS,W 107-102,240,37,85,0.435,25,45,0.556,12,40,0.3,21,26,0.808,107,40,85,0.471,30,54,0.556,10,31,0.323,12,12,1,102
71,2021/3/4,SAS,OKC,L 102-107,240,40,85,0.471,30,54,0.556,10,31,0.323,12,12,1,102,37,85,0.435,25,45,0.556,12,40,0.3,21,26,0.808,107
72,2021/3/4,LAC,WAS,L 117-119,240,38,82,0.463,22,47,0.468,16,35,0.457,25,27,0.926,117,40,88,0.455,31,65,0.477,9,23,0.391,30,42,0.714,119
73,2021/3/4,WAS,LAC,W 119-117,240,40,88,0.455,31,65,0.477,9,23,0.391,30,42,0.714,119,38,82,0.463,22,47,0.468,16,35,0.457,25,27,0.926,117
74,2021/3/3,CLE,IND,L 111-114,240,43,83,0.518,32,55,0.582,11,28,0.393,14,15,0.933,111,47,83,0.566,39,58,0.672,8,25,0.32,12,16,0.75,114
75,2021/3/3,IND,CLE,W 114-111,240,47,83,0.566,39,58,0.672,8,25,0.32,12,16,0.75,114,43,83,0.518,32,55,0.582,11,28,0.393,14,15,0.933,111
76,2021/3/3,DAL,OKC,W 87-78,240,32,83,0.386,24,43,0.558,8,40,0.2,15,19,0.789,87,29,87,0.333,20,48,0.417,9,39,0.231,11,17,0.647,78
77,2021/3/3,OKC,DAL,L 78-87,240,29,87,0.333,20,48,0.417,9,39,0.231,11,17,0.647,78,32,83,0.386,24,43,0.558,8,40,0.2,15,19,0.789,87
78,2021/3/3,BRK,HOU,W 132-114,240,49,85,0.576,32,50,0.64,17,35,0.486,17,24,0.708,132,38,91,0.418,20,48,0.417,18,43,0.419,20,28,0.714,114
79,2021/3/3,HOU,BRK,L 114-132,240,38,91,0.418,20,48,0.417,18,43,0.419,20,28,0.714,114,49,85,0.576,32,50,0.64,17,35,0.486,17,24,0.708,132
80,2021/3/3,CHO,MIN,W 135-102,240,51,98,0.52,34,59,0.576,17,39,0.436,16,21,0.762,135,39,96,0.406,30,56,0.536,9,40,0.225,15,18,0.833,102
81,2021/3/3,MIN,CHO,L 102-135,240,39,96,0.406,30,56,0.536,9,40,0.225,15,18,0.833,102,51,98,0.52,34,59,0.576,17,39,0.436,16,21,0.762,135
82,2021/3/3,CHI,NOP,W 128-124,240,48,94,0.511,36,66,0.545,12,28,0.429,20,22,0.909,128,46,83,0.554,40,61,0.656,6,22,0.273,26,38,0.684,124
83,2021/3/3,NOP,CHI,L 124-128,240,46,83,0.554,40,61,0.656,6,22,0.273,26,38,0.684,124,48,94,0.511,36,66,0.545,12,28,0.429,20,22,0.909,128
84,2021/3/3,ATL,ORL,W 115-112,240,38,85,0.447,17,40,0.425,21,45,0.467,18,19,0.947,115,36,84,0.429,23,49,0.469,13,35,0.371,27,27,1,112
85,2021/3/3,ORL,ATL,L 112-115,240,36,84,0.429,23,49,0.469,13,35,0.371,27,27,1,112,38,85,0.447,17,40,0.425,21,45,0.467,18,19,0.947,115
86,2021/3/3,PHI,UTA,W 131-123 (OT),265,48,93,0.516,40,68,0.588,8,25,0.32,27,35,0.771,131,44,100,0.44,23,56,0.411,21,44,0.477,14,19,0.737,123
87,2021/3/3,UTA,PHI,L 123-131 (OT),265,44,100,0.44,23,56,0.411,21,44,0.477,14,19,0.737,123,48,93,0.516,40,68,0.588,8,25,0.32,27,35,0.771,131
88,2021/3/3,GSW,POR,L 106-108,240,41,97,0.423,26,55,0.473,15,42,0.357,9,14,0.643,106,36,86,0.419,22,37,0.595,14,49,0.286,22,26,0.846,108
89,2021/3/3,POR,GSW,W 108-106,240,36,86,0.419,22,37,0.595,14,49,0.286,22,26,0.846,108,41,97,0.423,26,55,0.473,15,42,0.357,9,14,0.643,106
90,2021/3/3,LAL,SAC,L 120-123,240,49,93,0.527,37,66,0.561,12,27,0.444,10,14,0.714,120,48,80,0.6,36,55,0.655,12,25,0.48,15,19,0.789,123
91,2021/3/3,SAC,LAL,W 123-120,240,48,80,0.6,36,55,0.655,12,25,0.48,15,19,0.789,123,49,93,0.527,37,66,0.561,12,27,0.444,10,14,0.714,120
92,2021/3/3,DET,TOR,W 129-105,240,48,91,0.527,28,50,0.56,20,41,0.488,13,21,0.619,129,34,77,0.442,22,41,0.537,12,36,0.333,25,30,0.833,105
93,2021/3/3,TOR,DET,L 105-129,240,34,77,0.442,22,41,0.537,12,36,0.333,25,30,0.833,105,48,91,0.527,28,50,0.56,20,41,0.488,13,21,0.619,129
94,2021/3/2,BOS,LAC,W 117-112,240,42,86,0.488,26,54,0.481,16,32,0.5,17,23,0.739,117,43,87,0.494,25,49,0.51,18,38,0.474,8,9,0.889,112
95,2021/3/2,LAC,BOS,L 112-117,240,43,87,0.494,25,49,0.51,18,38,0.474,8,9,0.889,112,42,86,0.488,26,54,0.481,16,32,0.5,17,23,0.739,117
96,2021/3/2,LAL,PHO,L 104-114,240,40,79,0.506,29,48,0.604,11,31,0.355,13,17,0.765,104,38,77,0.494,22,48,0.458,16,29,0.552,22,25,0.88,114
97,2021/3/2,PHO,LAL,W 114-104,240,38,77,0.494,22,48,0.458,16,29,0.552,22,25,0.88,114,40,79,0.506,29,48,0.604,11,31,0.355,13,17,0.765,104
98,2021/3/2,ATL,MIA,W 94-80,240,34,71,0.479,21,35,0.6,13,36,0.361,13,15,0.867,94,28,75,0.373,19,42,0.452,9,33,0.273,15,22,0.682,80
99,2021/3/2,MIA,ATL,L 80-94,240,28,75,0.373,19,42,0.452,9,33,0.273,15,22,0.682,80,34,71,0.479,21,35,0.6,13,36,0.361,13,15,0.867,94
100,2021/3/2,DEN,MIL,W 128-97,240,53,95,0.558,42,65,0.646,11,30,0.367,11,12,0.917,128,32,79,0.405,21,39,0.538,11,40,0.275,22,31,0.71,97
101,2021/3/2,MIL,DEN,L 97-128,240,32,79,0.405,21,39,0.538,11,40,0.275,22,31,0.71,97,53,95,0.558,42,65,0.646,11,30,0.367,11,12,0.917,128
102,2021/3/2,NYK,SAS,L 93-119,240,33,81,0.407,18,45,0.4,15,36,0.417,12,15,0.8,93,43,89,0.483,25,47,0.532,18,42,0.429,15,21,0.714,119
103,2021/3/2,SAS,NYK,W 119-93,240,43,89,0.483,25,47,0.532,18,42,0.429,15,21,0.714,119,33,81,0.407,18,45,0.4,15,36,0.417,12,15,0.8,93
104,2021/3/2,MEM,WAS,W 125-111,240,47,95,0.495,34,66,0.515,13,29,0.448,18,23,0.783,125,41,81,0.506,30,50,0.6,11,31,0.355,18,25,0.72,111
105,2021/3/2,WAS,MEM,L 111-125,240,41,81,0.506,30,50,0.6,11,31,0.355,18,25,0.72,111,47,95,0.495,34,66,0.515,13,29,0.448,18,23,0.783,125
106,2021/3/1,CHI,DEN,L 112-118,240,42,94,0.447,30,56,0.536,12,38,0.316,16,22,0.727,112,46,87,0.529,36,60,0.6,10,27,0.37,16,20,0.8,118
107,2021/3/1,DEN,CHI,W 118-112,240,46,87,0.529,36,60,0.6,10,27,0.37,16,20,0.8,118,42,94,0.447,30,56,0.536,12,38,0.316,16,22,0.727,112
108,2021/3/1,CLE,HOU,W 101-90,240,36,73,0.493,26,43,0.605,10,30,0.333,19,24,0.792,101,31,76,0.408,21,45,0.467,10,31,0.323,18,24,0.75,90
109,2021/3/1,HOU,CLE,L 90-101,240,31,76,0.408,21,45,0.467,10,31,0.323,18,24,0.75,90,36,73,0.493,26,43,0.605,10,30,0.333,19,24,0.792,101
110,2021/3/1,NOP,UTA,W 129-124,240,52,92,0.565,45,81,0.556,7,11,0.636,18,23,0.783,129,46,101,0.455,29,58,0.5,17,43,0.395,15,18,0.833,124
111,2021/3/1,UTA,NOP,L 124-129,240,46,101,0.455,29,58,0.5,17,43,0.395,15,18,0.833,124,52,92,0.565,45,81,0.556,7,11,0.636,18,23,0.783,129
112,2021/3/1,DAL,ORL,W 130-124,240,47,90,0.522,30,44,0.682,17,46,0.37,19,23,0.826,130,47,95,0.495,27,54,0.5,20,41,0.488,10,14,0.714,124
113,2021/3/1,ORL,DAL,L 124-130,240,47,95,0.495,27,54,0.5,20,41,0.488,10,14,0.714,124,47,90,0.522,30,44,0.682,17,46,0.37,19,23,0.826,130
114,2021/3/1,IND,PHI,L 114-130,240,44,91,0.484,36,62,0.581,8,29,0.276,18,21,0.857,114,50,88,0.568,35,53,0.66,15,35,0.429,15,16,0.938,130
115,2021/3/1,PHI,IND,W 130-114,240,50,88,0.568,35,53,0.66,15,35,0.429,15,16,0.938,130,44,91,0.484,36,62,0.581,8,29,0.276,18,21,0.857,114
116,2021/3/1,CHO,POR,L 111-123,240,43,88,0.489,28,54,0.519,15,34,0.441,10,17,0.588,111,46,86,0.535,22,40,0.55,24,46,0.522,7,10,0.7,123
117,2021/3/1,POR,CHO,W 123-111,240,46,86,0.535,22,40,0.55,24,46,0.522,7,10,0.7,123,43,88,0.489,28,54,0.519,15,34,0.441,10,17,0.588,111
118,2021/3/1,BRK,SAS,W 124-113 (OT),265,47,100,0.47,30,59,0.508,17,41,0.415,13,17,0.765,124,44,97,0.454,29,62,0.468,15,35,0.429,10,15,0.667,113
119,2021/3/1,SAS,BRK,L 113-124 (OT),265,44,97,0.454,29,62,0.468,15,35,0.429,10,15,0.667,113,47,100,0.47,30,59,0.508,17,41,0.415,13,17,0.765,124
120,2021/2/28,BOS,WAS,W 111-110,240,42,89,0.472,32,59,0.542,10,30,0.333,17,24,0.708,111,38,84,0.452,29,52,0.558,9,32,0.281,25,29,0.862,110
121,2021/2/28,WAS,BOS,L 110-111,240,38,84,0.452,29,52,0.558,9,32,0.281,25,29,0.862,110,42,89,0.472,32,59,0.542,10,30,0.333,17,24,0.708,111
122,2021/2/28,DET,NYK,L 90-109,240,28,72,0.389,19,40,0.475,9,32,0.281,25,31,0.806,90,44,86,0.512,31,60,0.517,13,26,0.5,8,10,0.8,109
123,2021/2/28,NYK,DET,W 109-90,240,44,86,0.512,31,60,0.517,13,26,0.5,8,10,0.8,109,28,72,0.389,19,40,0.475,9,32,0.281,25,31,0.806,90
124,2021/2/28,HOU,MEM,L 84-133,240,23,83,0.277,19,38,0.5,4,45,0.089,34,41,0.829,84,50,94,0.532,40,64,0.625,10,30,0.333,23,28,0.821,133
125,2021/2/28,MEM,HOU,W 133-84,240,50,94,0.532,40,64,0.625,10,30,0.333,23,28,0.821,133,23,83,0.277,19,38,0.5,4,45,0.089,34,41,0.829,84
126,2021/2/28,GSW,LAL,L 91-117,240,35,86,0.407,27,52,0.519,8,34,0.235,13,19,0.684,91,40,85,0.471,29,54,0.537,11,31,0.355,26,38,0.684,117
127,2021/2/28,LAL,GSW,W 117-91,240,40,85,0.471,29,54,0.537,11,31,0.355,26,38,0.684,117,35,86,0.407,27,52,0.519,8,34,0.235,13,19,0.684,91
128,2021/2/28,ATL,MIA,L 99-109,240,36,87,0.414,28,52,0.538,8,35,0.229,19,22,0.864,99,39,86,0.453,28,49,0.571,11,37,0.297,20,22,0.909,109
129,2021/2/28,MIA,ATL,W 109-99,240,39,86,0.453,28,49,0.571,11,37,0.297,20,22,0.909,109,36,87,0.414,28,52,0.538,8,35,0.229,19,22,0.864,99
130,2021/2/28,LAC,MIL,L 100-105,240,40,97,0.412,26,53,0.491,14,44,0.318,6,7,0.857,100,38,85,0.447,26,47,0.553,12,38,0.316,17,22,0.773,105
131,2021/2/28,MIL,LAC,W 105-100,240,38,85,0.447,26,47,0.553,12,38,0.316,17,22,0.773,105,40,97,0.412,26,53,0.491,14,44,0.318,6,7,0.857,100
132,2021/2/28,MIN,PHO,L 99-118,240,35,93,0.376,27,58,0.466,8,35,0.229,21,24,0.875,99,44,89,0.494,37,62,0.597,7,27,0.259,23,24,0.958,118
133,2021/2/28,PHO,MIN,W 118-99,240,44,89,0.494,37,62,0.597,7,27,0.259,23,24,0.958,118,35,93,0.376,27,58,0.466,8,35,0.229,21,24,0.875,99
134,2021/2/28,CHO,SAC,W 127-126,240,45,83,0.542,34,53,0.642,11,30,0.367,26,27,0.963,127,50,92,0.543,34,56,0.607,16,36,0.444,10,17,0.588,126
135,2021/2/28,SAC,CHO,L 126-127,240,50,92,0.543,34,56,0.607,16,36,0.444,10,17,0.588,126,45,83,0.542,34,53,0.642,11,30,0.367,26,27,0.963,127
136,2021/2/27,BRK,DAL,L 98-115,240,35,86,0.407,21,42,0.5,14,44,0.318,14,19,0.737,98,45,86,0.523,31,50,0.62,14,36,0.389,11,17,0.647,115
137,2021/2/27,DAL,BRK,W 115-98,240,45,86,0.523,31,50,0.62,14,36,0.389,11,17,0.647,115,35,86,0.407,21,42,0.5,14,44,0.318,14,19,0.737,98
138,2021/2/27,IND,NYK,L 107-110,240,38,84,0.452,27,56,0.482,11,28,0.393,20,25,0.8,107,40,81,0.494,28,57,0.491,12,24,0.5,18,22,0.818,110
139,2021/2/27,NYK,IND,W 110-107,240,40,81,0.494,28,57,0.491,12,24,0.5,18,22,0.818,110,38,84,0.452,27,56,0.482,11,28,0.393,20,25,0.8,107
140,2021/2/27,DEN,OKC,W 126-96,240,49,89,0.551,34,58,0.586,15,31,0.484,13,16,0.813,126,37,88,0.42,26,41,0.634,11,47,0.234,11,15,0.733,96
141,2021/2/27,OKC,DEN,L 96-126,240,37,88,0.42,26,41,0.634,11,47,0.234,11,15,0.733,96,49,89,0.551,34,58,0.586,15,31,0.484,13,16,0.813,126
142,2021/2/27,ORL,UTA,L 109-124,240,44,96,0.458,30,62,0.484,14,34,0.412,7,8,0.875,109,45,85,0.529,28,40,0.7,17,45,0.378,17,24,0.708,124
143,2021/2/27,UTA,ORL,W 124-109,240,45,85,0.529,28,40,0.7,17,45,0.378,17,24,0.708,124,44,96,0.458,30,62,0.484,14,34,0.412,7,8,0.875,109
144,2021/2/27,CLE,PHI,W 112-109 (OT),265,41,97,0.423,33,73,0.452,8,24,0.333,22,29,0.759,112,38,83,0.458,28,55,0.509,10,28,0.357,23,35,0.657,109
145,2021/2/27,PHI,CLE,L 109-112 (OT),265,38,83,0.458,28,55,0.509,10,28,0.357,23,35,0.657,109,41,97,0.423,33,73,0.452,8,24,0.333,22,29,0.759,112
146,2021/2/27,NOP,SAS,L 114-117,240,40,91,0.44,31,59,0.525,9,32,0.281,25,31,0.806,114,41,86,0.477,29,54,0.537,12,32,0.375,23,28,0.821,117
147,2021/2/27,SAS,NOP,W 117-114,240,41,86,0.477,29,54,0.537,12,32,0.375,23,28,0.821,117,40,91,0.44,31,59,0.525,9,32,0.281,25,31,0.806,114
148,2021/2/27,MIN,WAS,L 112-128,240,41,95,0.432,30,60,0.5,11,35,0.314,19,29,0.655,112,44,98,0.449,31,65,0.477,13,33,0.394,27,34,0.794,128
149,2021/2/27,WAS,MIN,W 128-112,240,44,98,0.449,31,65,0.477,13,33,0.394,27,34,0.794,128,41,95,0.432,30,60,0.5,11,35,0.314,19,29,0.655,112
150,2021/2/26,BOS,IND,W 118-112,240,42,82,0.512,33,60,0.55,9,22,0.409,25,29,0.862,118,35,89,0.393,20,43,0.465,15,46,0.326,27,29,0.931,112
151,2021/2/26,IND,BOS,L 112-118,240,35,89,0.393,20,43,0.465,15,46,0.326,27,29,0.931,112,42,82,0.512,33,60,0.55,9,22,0.409,25,29,0.862,118
152,2021/2/26,CHI,PHO,L 97-106,240,39,78,0.5,27,47,0.574,12,31,0.387,7,10,0.7,97,44,88,0.5,38,66,0.576,6,22,0.273,12,15,0.8,106
153,2021/2/26,PHO,CHI,W 106-97,240,44,88,0.5,38,66,0.576,6,22,0.273,12,15,0.8,106,39,78,0.5,27,47,0.574,12,31,0.387,7,10,0.7,97
154,2021/2/26,DET,SAC,L 107-110,240,37,82,0.451,25,49,0.51,12,33,0.364,21,32,0.656,107,37,89,0.416,30,57,0.526,7,32,0.219,29,41,0.707,110
155,2021/2/26,SAC,DET,W 110-107,240,37,89,0.416,30,57,0.526,7,32,0.219,29,41,0.707,110,37,82,0.451,25,49,0.51,12,33,0.364,21,32,0.656,107
156,2021/2/26,CHO,GSW,L 121-130,240,41,89,0.461,24,48,0.5,17,41,0.415,22,32,0.688,121,48,79,0.608,37,55,0.673,11,24,0.458,23,25,0.92,130
157,2021/2/26,GSW,CHO,W 130-121,240,48,79,0.608,37,55,0.673,11,24,0.458,23,25,0.92,130,41,89,0.461,24,48,0.5,17,41,0.415,22,32,0.688,121
158,2021/2/26,LAL,POR,W 102-93,240,37,88,0.42,30,61,0.492,7,27,0.259,21,28,0.75,102,32,83,0.386,21,46,0.457,11,37,0.297,18,20,0.9,93
159,2021/2/26,POR,LAL,L 93-102,240,32,83,0.386,21,46,0.457,11,37,0.297,18,20,0.9,93,37,88,0.42,30,61,0.492,7,27,0.259,21,28,0.75,102
160,2021/2/26,LAC,MEM,W 119-99,240,44,80,0.55,30,45,0.667,14,35,0.4,17,18,0.944,119,39,97,0.402,30,69,0.435,9,28,0.321,12,16,0.75,99
161,2021/2/26,MEM,LAC,L 99-119,240,39,97,0.402,30,69,0.435,9,28,0.321,12,16,0.75,99,44,80,0.55,30,45,0.667,14,35,0.4,17,18,0.944,119
162,2021/2/26,MIA,UTA,W 124-116,240,44,86,0.512,30,55,0.545,14,31,0.452,22,25,0.88,124,40,94,0.426,25,48,0.521,15,46,0.326,21,23,0.913,116
163,2021/2/26,UTA,MIA,L 116-124,240,40,94,0.426,25,48,0.521,15,46,0.326,21,23,0.913,116,44,86,0.512,30,55,0.545,14,31,0.452,22,25,0.88,124
164,2021/2/26,ATL,OKC,L 109-118,240,43,97,0.443,31,57,0.544,12,40,0.3,11,17,0.647,109,46,88,0.523,30,46,0.652,16,42,0.381,10,16,0.625,118
165,2021/2/26,OKC,ATL,W 118-109,240,46,88,0.523,30,46,0.652,16,42,0.381,10,16,0.625,118,43,97,0.443,31,57,0.544,12,40,0.3,11,17,0.647,109
166,2021/2/26,HOU,TOR,L 111-122,240,39,91,0.429,23,44,0.523,16,47,0.34,17,20,0.85,111,40,89,0.449,24,48,0.5,16,41,0.39,26,27,0.963,122
167,2021/2/26,TOR,HOU,W 122-111,240,40,89,0.449,24,48,0.5,16,41,0.39,26,27,0.963,122,39,91,0.429,23,44,0.523,16,47,0.34,17,20,0.85,111
168,2021/2/25,BRK,ORL,W 129-92,240,49,92,0.533,29,47,0.617,20,45,0.444,11,14,0.786,129,35,87,0.402,26,51,0.51,9,36,0.25,13,15,0.867,92
169,2021/2/25,ORL,BRK,L 92-129,240,35,87,0.402,26,51,0.51,9,36,0.25,13,15,0.867,92,49,92,0.533,29,47,0.617,20,45,0.444,11,14,0.786,129
170,2021/2/25,DEN,WAS,L 110-112,240,37,85,0.435,22,47,0.468,15,38,0.395,21,24,0.875,110,41,86,0.477,33,60,0.55,8,26,0.308,22,25,0.88,112
171,2021/2/25,WAS,DEN,W 112-110,240,41,86,0.477,33,60,0.55,8,26,0.308,22,25,0.88,112,37,85,0.435,22,47,0.468,15,38,0.395,21,24,0.875,110
172,2021/2/25,LAC,MEM,L 94-122,240,34,84,0.405,22,50,0.44,12,34,0.353,14,16,0.875,94,50,92,0.543,39,73,0.534,11,19,0.579,11,16,0.688,122
173,2021/2/25,MEM,LAC,W 122-94,240,50,92,0.543,39,73,0.534,11,19,0.579,11,16,0.688,122,34,84,0.405,22,50,0.44,12,34,0.353,14,16,0.875,94
174,2021/2/25,MIL,NOP,W 129-125,240,52,96,0.542,39,65,0.6,13,31,0.419,12,16,0.75,129,51,102,0.5,38,63,0.603,13,39,0.333,10,14,0.714,125
175,2021/2/25,NOP,MIL,L 125-129,240,51,102,0.5,38,63,0.603,13,39,0.333,10,14,0.714,125,52,96,0.542,39,65,0.6,13,31,0.419,12,16,0.75,129
176,2021/2/25,NYK,SAC,W 140-121,240,51,87,0.586,32,51,0.627,19,36,0.528,19,21,0.905,140,42,85,0.494,30,50,0.6,12,35,0.343,25,33,0.758,121
177,2021/2/25,SAC,NYK,L 121-140,240,42,85,0.494,30,50,0.6,12,35,0.343,25,33,0.758,121,51,87,0.586,32,51,0.627,19,36,0.528,19,21,0.905,140
178,2021/2/25,DAL,PHI,L 97-111,240,32,78,0.41,19,44,0.432,13,34,0.382,20,23,0.87,97,39,90,0.433,27,61,0.443,12,29,0.414,21,25,0.84,111
179,2021/2/25,PHI,DAL,W 111-97,240,39,90,0.433,27,61,0.443,12,29,0.414,21,25,0.84,111,32,78,0.41,19,44,0.432,13,34,0.382,20,23,0.87,97
180,2021/2/24,ATL,BOS,W 127-112,240,45,85,0.529,22,43,0.512,23,42,0.548,14,17,0.824,127,42,95,0.442,34,64,0.531,8,31,0.258,20,23,0.87,112
181,2021/2/24,BOS,ATL,L 112-127,240,42,95,0.442,34,64,0.531,8,31,0.258,20,23,0.87,112,45,85,0.529,22,43,0.512,23,42,0.548,14,17,0.824,127
182,2021/2/24,CHI,MIN,W 133-126 (OT),265,55,93,0.591,45,68,0.662,10,25,0.4,13,16,0.813,133,47,104,0.452,35,66,0.53,12,38,0.316,20,21,0.952,126
183,2021/2/24,MIN,CHI,L 126-133 (OT),265,47,104,0.452,35,66,0.53,12,38,0.316,20,21,0.952,126,55,93,0.591,45,68,0.662,10,25,0.4,13,16,0.813,133
184,2021/2/24,CLE,HOU,W 112-96,240,43,85,0.506,27,49,0.551,16,36,0.444,10,15,0.667,112,36,90,0.4,26,57,0.456,10,33,0.303,14,17,0.824,96
185,2021/2/24,HOU,CLE,L 96-112,240,36,90,0.4,26,57,0.456,10,33,0.303,14,17,0.824,96,43,85,0.506,27,49,0.551,16,36,0.444,10,15,0.667,112
186,2021/2/24,GSW,IND,W 111-107,240,39,83,0.47,34,57,0.596,5,26,0.192,28,31,0.903,111,37,81,0.457,30,52,0.577,7,29,0.241,26,32,0.813,107
187,2021/2/24,IND,GSW,L 107-111,240,37,81,0.457,30,52,0.577,7,29,0.241,26,32,0.813,107,39,83,0.47,34,57,0.596,5,26,0.192,28,31,0.903,111
188,2021/2/24,MIA,TOR,W 116-108,240,37,80,0.463,20,42,0.476,17,38,0.447,25,29,0.862,116,37,74,0.5,17,30,0.567,20,44,0.455,14,17,0.824,108
189,2021/2/24,TOR,MIA,L 108-116,240,37,74,0.5,17,30,0.567,20,44,0.455,14,17,0.824,108,37,80,0.463,20,42,0.476,17,38,0.447,25,29,0.862,116
190,2021/2/24,DET,NOP,L 118-128,240,47,89,0.528,34,53,0.642,13,36,0.361,11,16,0.688,118,50,90,0.556,40,67,0.597,10,23,0.435,18,29,0.621,128
191,2021/2/24,NOP,DET,W 128-118,240,50,90,0.556,40,67,0.597,10,23,0.435,18,29,0.621,128,47,89,0.528,34,53,0.642,13,36,0.361,11,16,0.688,118
192,2021/2/24,OKC,SAS,W 102-99,240,37,89,0.416,19,45,0.422,18,44,0.409,10,11,0.909,102,40,86,0.465,31,61,0.508,9,25,0.36,10,15,0.667,99
193,2021/2/24,SAS,OKC,L 99-102,240,40,86,0.465,31,61,0.508,9,25,0.36,10,15,0.667,99,37,89,0.416,19,45,0.422,18,44,0.409,10,11,0.909,102
194,2021/2/24,CHO,PHO,W 124-121,240,43,88,0.489,30,52,0.577,13,36,0.361,25,27,0.926,124,44,87,0.506,30,49,0.612,14,38,0.368,19,27,0.704,121
195,2021/2/24,PHO,CHO,L 121-124,240,44,87,0.506,30,49,0.612,14,38,0.368,19,27,0.704,121,43,88,0.489,30,52,0.577,13,36,0.361,25,27,0.926,124
196,2021/2/24,LAL,UTA,L 89-114,240,34,85,0.4,26,52,0.5,8,33,0.242,13,20,0.65,89,41,87,0.471,19,39,0.487,22,48,0.458,10,15,0.667,114
197,2021/2/24,UTA,LAL,W 114-89,240,41,87,0.471,19,39,0.487,22,48,0.458,10,15,0.667,114,34,85,0.4,26,52,0.5,8,33,0.242,13,20,0.65,89
198,2021/2/23,BRK,SAC,W 127-118,240,44,89,0.494,27,49,0.551,17,40,0.425,22,31,0.71,127,45,87,0.517,30,56,0.536,15,31,0.484,13,19,0.684,118
199,2021/2/23,SAC,BRK,L 118-127,240,45,87,0.517,30,56,0.536,15,31,0.484,13,19,0.684,118,44,89,0.494,27,49,0.551,17,40,0.425,22,31,0.71,127
200,2021/2/23,ATL,CLE,L 111-112,240,40,89,0.449,26,58,0.448,14,31,0.452,17,23,0.739,111,41,78,0.526,26,50,0.52,15,28,0.536,15,19,0.789,112
201,2021/2/23,CLE,ATL,W 112-111,240,41,78,0.526,26,50,0.52,15,28,0.536,15,19,0.789,112,40,89,0.449,26,58,0.448,14,31,0.452,17,23,0.739,111
202,2021/2/23,BOS,DAL,L 107-110,240,41,86,0.477,29,47,0.617,12,39,0.308,13,18,0.722,107,42,89,0.472,29,56,0.518,13,33,0.394,13,15,0.867,110
203,2021/2/23,DAL,BOS,W 110-107,240,42,89,0.472,29,56,0.518,13,33,0.394,13,15,0.867,110,41,86,0.477,29,47,0.617,12,39,0.308,13,18,0.722,107
204,2021/2/23,DEN,POR,W 111-106,240,40,94,0.426,26,58,0.448,14,36,0.389,17,18,0.944,111,41,87,0.471,27,46,0.587,14,41,0.341,10,10,1,106
205,2021/2/23,POR,DEN,L 106-111,240,41,87,0.471,27,46,0.587,14,41,0.341,10,10,1,106,40,94,0.426,26,58,0.448,14,36,0.389,17,18,0.944,111
206,2021/2/23,LAC,WAS,W 135-116,240,54,94,0.574,35,56,0.625,19,38,0.5,8,13,0.615,135,47,88,0.534,36,68,0.529,11,20,0.55,11,16,0.688,116
207,2021/2/23,WAS,LAC,L 116-135,240,47,88,0.534,36,68,0.529,11,20,0.55,11,16,0.688,116,54,94,0.574,35,56,0.625,19,38,0.5,8,13,0.615,135
208,2021/2/23,MIL,MIN,W 139-112,240,53,99,0.535,33,57,0.579,20,42,0.476,13,18,0.722,139,42,98,0.429,23,44,0.523,19,54,0.352,9,9,1,112
209,2021/2/23,MIN,MIL,L 112-139,240,42,98,0.429,23,44,0.523,19,54,0.352,9,9,1,112,53,99,0.535,33,57,0.579,20,42,0.476,13,18,0.722,139
210,2021/2/23,GSW,NYK,W 114-106,240,40,89,0.449,27,51,0.529,13,38,0.342,21,24,0.875,114,38,97,0.392,27,68,0.397,11,29,0.379,19,22,0.864,106
211,2021/2/23,NYK,GSW,L 106-114,240,38,97,0.392,27,68,0.397,11,29,0.379,19,22,0.864,106,40,89,0.449,27,51,0.529,13,38,0.342,21,24,0.875,114
212,2021/2/23,DET,ORL,W 105-93,240,41,88,0.466,31,54,0.574,10,34,0.294,13,16,0.813,105,33,88,0.375,19,50,0.38,14,38,0.368,13,22,0.591,93
213,2021/2/23,ORL,DET,L 93-105,240,33,88,0.375,19,50,0.38,14,38,0.368,13,22,0.591,93,41,88,0.466,31,54,0.574,10,34,0.294,13,16,0.813,105
214,2021/2/23,PHI,TOR,W 109-102,240,33,80,0.413,16,42,0.381,17,38,0.447,26,30,0.867,109,40,93,0.43,29,56,0.518,11,37,0.297,11,13,0.846,102
215,2021/2/23,TOR,PHI,L 102-109,240,40,93,0.43,29,56,0.518,11,37,0.297,11,13,0.846,102,33,80,0.413,16,42,0.381,17,38,0.447,26,30,0.867,109
216,2021/2/22,DAL,MEM,W 102-92,240,35,80,0.438,20,39,0.513,15,41,0.366,17,26,0.654,102,37,94,0.394,31,63,0.492,6,31,0.194,12,19,0.632,92
217,2021/2/22,MEM,DAL,L 92-102,240,37,94,0.394,31,63,0.492,6,31,0.194,12,19,0.632,92,35,80,0.438,20,39,0.513,15,41,0.366,17,26,0.654,102
218,2021/2/22,CHI,HOU,W 120-100,240,49,91,0.538,34,55,0.618,15,36,0.417,7,10,0.7,120,37,96,0.385,24,56,0.429,13,40,0.325,13,19,0.684,100
219,2021/2/22,HOU,CHI,L 100-120,240,37,96,0.385,24,56,0.429,13,40,0.325,13,19,0.684,100,49,91,0.538,34,55,0.618,15,36,0.417,7,10,0.7,120
220,2021/2/22,LAL,WAS,L 124-127 (OT),265,49,104,0.471,34,60,0.567,15,44,0.341,11,17,0.647,124,47,96,0.49,38,71,0.535,9,25,0.36,24,33,0.727,127
221,2021/2/22,WAS,LAL,W 127-124 (OT),265,47,96,0.49,38,71,0.535,9,25,0.36,24,33,0.727,127,49,104,0.471,34,60,0.567,15,44,0.341,11,17,0.647,124
222,2021/2/22,MIA,OKC,W 108-94,240,36,81,0.444,21,41,0.512,15,40,0.375,21,25,0.84,108,32,74,0.432,18,35,0.514,14,39,0.359,16,19,0.842,94
223,2021/2/22,OKC,MIA,L 94-108,240,32,74,0.432,18,35,0.514,14,39,0.359,16,19,0.842,94,36,81,0.444,21,41,0.512,15,40,0.375,21,25,0.84,108
224,2021/2/22,PHO,POR,W 132-100,240,50,99,0.505,34,66,0.515,16,33,0.485,16,18,0.889,132,37,84,0.44,25,45,0.556,12,39,0.308,14,19,0.737,100
225,2021/2/22,POR,PHO,L 100-132,240,37,84,0.44,25,45,0.556,12,39,0.308,14,19,0.737,100,50,99,0.505,34,66,0.515,16,33,0.485,16,18,0.889,132
226,2021/2/22,CHO,UTA,L 110-132,240,41,89,0.461,30,53,0.566,11,36,0.306,17,21,0.81,110,45,85,0.529,17,30,0.567,28,55,0.509,14,17,0.824,132
227,2021/2/22,UTA,CHO,W 132-110,240,45,85,0.529,17,30,0.567,28,55,0.509,14,17,0.824,132,41,89,0.461,30,53,0.566,11,36,0.306,17,21,0.81,110
228,2021/2/21,ATL,DEN,W 123-115,240,42,81,0.519,30,47,0.638,12,34,0.353,27,33,0.818,123,43,84,0.512,27,48,0.563,16,36,0.444,13,16,0.813,115
229,2021/2/21,DEN,ATL,L 115-123,240,43,84,0.512,27,48,0.563,16,36,0.444,13,16,0.813,115,42,81,0.519,30,47,0.638,12,34,0.353,27,33,0.818,123
230,2021/2/21,CLE,OKC,L 101-117,240,39,84,0.464,31,49,0.633,8,35,0.229,15,20,0.75,101,43,79,0.544,30,51,0.588,13,28,0.464,18,24,0.75,117
231,2021/2/21,OKC,CLE,W 117-101,240,43,79,0.544,30,51,0.588,13,28,0.464,18,24,0.75,117,39,84,0.464,31,49,0.633,8,35,0.229,15,20,0.75,101
232,2021/2/21,BRK,LAC,W 112-108,240,44,92,0.478,33,54,0.611,11,38,0.289,13,19,0.684,112,40,87,0.46,25,52,0.481,15,35,0.429,13,18,0.722,108
233,2021/2/21,LAC,BRK,L 108-112,240,40,87,0.46,25,52,0.481,15,35,0.429,13,18,0.722,108,44,92,0.478,33,54,0.611,11,38,0.289,13,19,0.684,112
234,2021/2/21,MIL,SAC,W 128-115,240,44,90,0.489,33,62,0.532,11,28,0.393,29,36,0.806,128,44,100,0.44,32,67,0.478,12,33,0.364,15,20,0.75,115
235,2021/2/21,SAC,MIL,L 115-128,240,44,100,0.44,32,67,0.478,12,33,0.364,15,20,0.75,115,44,90,0.489,33,62,0.532,11,28,0.393,29,36,0.806,128
236,2021/2/21,BOS,NOP,L 115-120 (OT),265,39,98,0.398,29,61,0.475,10,37,0.27,27,34,0.794,115,42,94,0.447,31,58,0.534,11,36,0.306,25,37,0.676,120
237,2021/2/21,NOP,BOS,W 120-115 (OT),265,42,94,0.447,31,58,0.534,11,36,0.306,25,37,0.676,120,39,98,0.398,29,61,0.475,10,37,0.27,27,34,0.794,115
238,2021/2/21,MIN,NYK,L 99-103,240,33,82,0.402,17,47,0.362,16,35,0.457,17,21,0.81,99,33,78,0.423,27,60,0.45,6,18,0.333,31,38,0.816,103
239,2021/2/21,NYK,MIN,W 103-99,240,33,78,0.423,27,60,0.45,6,18,0.333,31,38,0.816,103,33,82,0.402,17,47,0.362,16,35,0.457,17,21,0.81,99
240,2021/2/21,DET,ORL,L 96-105,240,34,91,0.374,23,51,0.451,11,40,0.275,17,21,0.81,96,35,81,0.432,26,51,0.51,9,30,0.3,26,29,0.897,105
241,2021/2/21,ORL,DET,W 105-96,240,35,81,0.432,26,51,0.51,9,30,0.3,26,29,0.897,105,34,91,0.374,23,51,0.451,11,40,0.275,17,21,0.81,96
242,2021/2/21,PHI,TOR,L 103-110,240,33,85,0.388,22,48,0.458,11,37,0.297,26,35,0.743,103,40,81,0.494,26,47,0.553,14,34,0.412,16,18,0.889,110
243,2021/2/21,TOR,PHI,W 110-103,240,40,81,0.494,26,47,0.553,14,34,0.412,16,18,0.889,110,33,85,0.388,22,48,0.458,11,37,0.297,26,35,0.743,103
244,2021/2/20,CHI,SAC,W 122-114,240,49,82,0.598,38,59,0.644,11,23,0.478,13,15,0.867,122,44,98,0.449,36,69,0.522,8,29,0.276,18,22,0.818,114
245,2021/2/20,SAC,CHI,L 114-122,240,44,98,0.449,36,69,0.522,8,29,0.276,18,22,0.818,114,49,82,0.598,38,59,0.644,11,23,0.478,13,15,0.867,122
246,2021/2/20,CHO,GSW,W 102-100,240,37,75,0.493,17,35,0.486,20,40,0.5,8,9,0.889,102,37,85,0.435,24,46,0.522,13,39,0.333,13,17,0.765,100
247,2021/2/20,GSW,CHO,L 100-102,240,37,85,0.435,24,46,0.522,13,39,0.333,13,17,0.765,100,37,75,0.493,17,35,0.486,20,40,0.5,8,9,0.889,102
248,2021/2/20,LAL,MIA,L 94-96,240,33,84,0.393,20,39,0.513,13,45,0.289,15,17,0.882,94,36,85,0.424,28,57,0.491,8,28,0.286,16,23,0.696,96
249,2021/2/20,MIA,LAL,W 96-94,240,36,85,0.424,28,57,0.491,8,28,0.286,16,23,0.696,96,33,84,0.393,20,39,0.513,13,45,0.289,15,17,0.882,94
250,2021/2/20,MEM,PHO,L 97-128,240,36,93,0.387,31,60,0.517,5,33,0.152,20,23,0.87,97,46,86,0.535,22,40,0.55,24,46,0.522,12,13,0.923,128
251,2021/2/20,PHO,MEM,W 128-97,240,46,86,0.535,22,40,0.55,24,46,0.522,12,13,0.923,128,36,93,0.387,31,60,0.517,5,33,0.152,20,23,0.87,97
252,2021/2/20,POR,WAS,L 111-118,240,37,103,0.359,18,48,0.375,19,55,0.345,18,25,0.72,111,45,89,0.506,39,63,0.619,6,26,0.231,22,29,0.759,118
253,2021/2/20,WAS,POR,W 118-111,240,45,89,0.506,39,63,0.619,6,26,0.231,22,29,0.759,118,37,103,0.359,18,48,0.375,19,55,0.345,18,25,0.72,111
254,2021/2/19,ATL,BOS,L 109-121,240,38,90,0.422,28,60,0.467,10,30,0.333,23,25,0.92,109,50,90,0.556,36,55,0.655,14,35,0.4,7,10,0.7,121
255,2021/2/19,BOS,ATL,W 121-109,240,50,90,0.556,36,55,0.655,14,35,0.4,7,10,0.7,121,38,90,0.422,28,60,0.467,10,30,0.333,23,25,0.92,109
256,2021/2/19,CLE,DEN,L 103-120,240,39,83,0.47,27,52,0.519,12,31,0.387,13,21,0.619,103,46,80,0.575,31,49,0.633,15,31,0.484,13,17,0.765,120
257,2021/2/19,DEN,CLE,W 120-103,240,46,80,0.575,31,49,0.633,15,31,0.484,13,17,0.765,120,39,83,0.47,27,52,0.519,12,31,0.387,13,21,0.619,103
258,2021/2/19,LAC,UTA,W 116-112,240,43,89,0.483,33,59,0.559,10,30,0.333,20,22,0.909,116,41,86,0.477,29,52,0.558,12,34,0.353,18,21,0.857,112
259,2021/2/19,UTA,LAC,L 112-116,240,41,86,0.477,29,52,0.558,12,34,0.353,18,21,0.857,112,43,89,0.483,33,59,0.559,10,30,0.333,20,22,0.909,116
260,2021/2/19,DET,MEM,L 95-109,240,36,86,0.419,22,41,0.537,14,45,0.311,9,13,0.692,95,42,90,0.467,37,70,0.529,5,20,0.25,20,23,0.87,109
261,2021/2/19,MEM,DET,W 109-95,240,42,90,0.467,37,70,0.529,5,20,0.25,20,23,0.87,109,36,86,0.419,22,41,0.537,14,45,0.311,9,13,0.692,95
262,2021/2/19,MIL,OKC,W 98-85,240,35,86,0.407,24,52,0.462,11,34,0.324,17,25,0.68,98,31,85,0.365,19,45,0.422,12,40,0.3,11,21,0.524,85
263,2021/2/19,OKC,MIL,L 85-98,240,31,85,0.365,19,45,0.422,12,40,0.3,11,21,0.524,85,35,86,0.407,24,52,0.462,11,34,0.324,17,25,0.68,98
264,2021/2/19,MIN,TOR,L 81-86,240,32,83,0.386,23,45,0.511,9,38,0.237,8,11,0.727,81,28,85,0.329,16,45,0.356,12,40,0.3,18,22,0.818,86
265,2021/2/19,TOR,MIN,W 86-81,240,28,85,0.329,16,45,0.356,12,40,0.3,18,22,0.818,86,32,83,0.386,23,45,0.511,9,38,0.237,8,11,0.727,81
266,2021/2/19,NOP,PHO,L 114-132,240,42,82,0.512,31,50,0.62,11,32,0.344,19,24,0.792,114,51,88,0.58,29,49,0.592,22,39,0.564,8,12,0.667,132
267,2021/2/19,PHO,NOP,W 132-114,240,51,88,0.58,29,49,0.592,22,39,0.564,8,12,0.667,132,42,82,0.512,31,50,0.62,11,32,0.344,19,24,0.792,114
268,2021/2/19,GSW,ORL,L 120-124,240,46,97,0.474,27,55,0.491,19,42,0.452,9,15,0.6,120,46,94,0.489,28,51,0.549,18,43,0.419,14,17,0.824,124
269,2021/2/19,ORL,GSW,W 124-120,240,46,94,0.489,28,51,0.549,18,43,0.419,14,17,0.824,124,46,97,0.474,27,55,0.491,19,42,0.452,9,15,0.6,120
270,2021/2/19,CHI,PHI,L 105-112,240,40,95,0.421,33,63,0.524,7,32,0.219,18,18,1,105,41,87,0.471,34,66,0.515,7,21,0.333,23,29,0.793,112
271,2021/2/19,PHI,CHI,W 112-105,240,41,87,0.471,34,66,0.515,7,21,0.333,23,29,0.793,112,40,95,0.421,33,63,0.524,7,32,0.219,18,18,1,105
272,2021/2/18,BRK,LAL,W 109-98,240,38,77,0.494,20,38,0.526,18,39,0.462,15,24,0.625,109,40,83,0.482,32,53,0.604,8,30,0.267,10,14,0.714,98
273,2021/2/18,LAL,BRK,L 98-109,240,40,83,0.482,32,53,0.604,8,30,0.267,10,14,0.714,98,38,77,0.494,20,38,0.526,18,39,0.462,15,24,0.625,109
274,2021/2/18,MIL,TOR,L 96-110,240,35,88,0.398,25,54,0.463,10,34,0.294,16,23,0.696,96,38,78,0.487,26,43,0.605,12,35,0.343,22,23,0.957,110
275,2021/2/18,TOR,MIL,W 110-96,240,38,78,0.487,26,43,0.605,12,35,0.343,22,23,0.957,110,35,88,0.398,25,54,0.463,10,34,0.294,16,23,0.696,96
276,2021/2/18,MIA,SAC,W 118-110,240,49,95,0.516,37,61,0.607,12,34,0.353,8,10,0.8,118,43,93,0.462,28,52,0.538,15,41,0.366,9,16,0.563,110
277,2021/2/18,SAC,MIA,L 110-118,240,43,93,0.462,28,52,0.538,15,41,0.366,9,16,0.563,110,49,95,0.516,37,61,0.607,12,34,0.353,8,10,0.8,118
278,2021/2/17,ATL,BOS,W 122-114,240,44,77,0.571,36,53,0.679,8,24,0.333,26,31,0.839,122,40,86,0.465,30,55,0.545,10,31,0.323,24,27,0.889,114
279,2021/2/17,BOS,ATL,L 114-122,240,40,86,0.465,30,55,0.545,10,31,0.323,24,27,0.889,114,44,77,0.571,36,53,0.679,8,24,0.333,26,31,0.839,122
280,2021/2/17,CHI,DET,W 105-102,240,41,85,0.482,33,57,0.579,8,28,0.286,15,24,0.625,105,37,82,0.451,29,54,0.537,8,28,0.286,20,24,0.833,102
281,2021/2/17,DET,CHI,L 102-105,240,37,82,0.451,29,54,0.537,8,28,0.286,20,24,0.833,102,41,85,0.482,33,57,0.579,8,28,0.286,15,24,0.625,105
282,2021/2/17,GSW,MIA,W 120-112 (OT),265,43,95,0.453,25,43,0.581,18,52,0.346,16,21,0.762,120,44,97,0.454,31,61,0.508,13,36,0.361,11,12,0.917,112
283,2021/2/17,MIA,GSW,L 112-120 (OT),265,44,97,0.454,31,61,0.508,13,36,0.361,11,12,0.917,112,43,95,0.453,25,43,0.581,18,52,0.346,16,21,0.762,120
284,2021/2/17,LAC,UTA,L 96-114,240,38,86,0.442,29,60,0.483,9,26,0.346,11,17,0.647,96,42,98,0.429,29,58,0.5,13,40,0.325,17,20,0.85,114
285,2021/2/17,UTA,LAC,W 114-96,240,42,98,0.429,29,58,0.5,13,40,0.325,17,20,0.85,114,38,86,0.442,29,60,0.483,9,26,0.346,11,17,0.647,96
286,2021/2/17,MEM,OKC,W 122-113,240,42,83,0.506,30,57,0.526,12,26,0.462,26,33,0.788,122,35,78,0.449,16,37,0.432,19,41,0.463,24,28,0.857,113
287,2021/2/17,OKC,MEM,L 113-122,240,35,78,0.449,16,37,0.432,19,41,0.463,24,28,0.857,113,42,83,0.506,30,57,0.526,12,26,0.462,26,33,0.788,122
288,2021/2/17,IND,MIN,W 134-128 (OT),265,49,97,0.505,36,71,0.507,13,26,0.5,23,27,0.852,134,45,107,0.421,30,67,0.448,15,40,0.375,23,25,0.92,128
289,2021/2/17,MIN,IND,L 128-134 (OT),265,45,107,0.421,30,67,0.448,15,40,0.375,23,25,0.92,128,49,97,0.505,36,71,0.507,13,26,0.5,23,27,0.852,134
290,2021/2/17,NOP,POR,L 124-126,240,43,89,0.483,28,57,0.491,15,32,0.469,23,29,0.793,124,46,90,0.511,28,49,0.571,18,41,0.439,16,18,0.889,126
291,2021/2/17,POR,NOP,W 126-124,240,46,90,0.511,28,49,0.571,18,41,0.439,16,18,0.889,126,43,89,0.483,28,57,0.491,15,32,0.469,23,29,0.793,124
292,2021/2/17,NYK,ORL,L 89-107,240,33,87,0.379,26,60,0.433,7,27,0.259,16,19,0.842,89,42,92,0.457,26,58,0.448,16,34,0.471,7,10,0.7,107
293,2021/2/17,ORL,NYK,W 107-89,240,42,92,0.457,26,58,0.448,16,34,0.471,7,10,0.7,107,33,87,0.379,26,60,0.433,7,27,0.259,16,19,0.842,89
294,2021/2/17,HOU,PHI,L 113-118,240,42,92,0.457,27,45,0.6,15,47,0.319,14,18,0.778,113,39,81,0.481,27,55,0.491,12,26,0.462,28,32,0.875,118
295,2021/2/17,PHI,HOU,W 118-113,240,39,81,0.481,27,55,0.491,12,26,0.462,28,32,0.875,118,42,92,0.457,27,45,0.6,15,47,0.319,14,18,0.778,113
296,2021/2/17,DEN,WAS,L 128-130,240,48,92,0.522,31,54,0.574,17,38,0.447,15,18,0.833,128,44,86,0.512,29,53,0.547,15,33,0.455,27,34,0.794,130
297,2021/2/17,WAS,DEN,W 130-128,240,44,86,0.512,29,53,0.547,15,33,0.455,27,34,0.794,130,48,92,0.522,31,54,0.574,17,38,0.447,15,18,0.833,128
298,2021/2/16,BOS,DEN,W 112-99,240,39,81,0.481,24,39,0.615,15,42,0.357,19,21,0.905,112,38,84,0.452,29,50,0.58,9,34,0.265,14,15,0.933,99
299,2021/2/16,DEN,BOS,L 99-112,240,38,84,0.452,29,50,0.58,9,34,0.265,14,15,0.933,99,39,81,0.481,24,39,0.615,15,42,0.357,19,21,0.905,112
300,2021/2/16,MEM,NOP,L 113-144,240,42,88,0.477,29,57,0.509,13,31,0.419,16,18,0.889,113,56,91,0.615,37,53,0.698,19,38,0.5,13,17,0.765,144
301,2021/2/16,NOP,MEM,W 144-113,240,56,91,0.615,37,53,0.698,19,38,0.5,13,17,0.765,144,42,88,0.477,29,57,0.509,13,31,0.419,16,18,0.889,113
302,2021/2/16,MIL,TOR,L 113-124,240,40,83,0.482,26,46,0.565,14,37,0.378,19,25,0.76,113,46,91,0.505,29,48,0.604,17,43,0.395,15,21,0.714,124
303,2021/2/16,TOR,MIL,W 124-113,240,46,91,0.505,29,48,0.604,17,43,0.395,15,21,0.714,124,40,83,0.482,26,46,0.565,14,37,0.378,19,25,0.76,113
304,2021/2/16,LAL,MIN,W 112-104,240,42,77,0.545,31,51,0.608,11,26,0.423,17,21,0.81,112,39,93,0.419,23,59,0.39,16,34,0.471,10,13,0.769,104
305,2021/2/16,MIN,LAL,L 104-112,240,39,93,0.419,23,59,0.39,16,34,0.471,10,13,0.769,104,42,77,0.545,31,51,0.608,11,26,0.423,17,21,0.81,112
306,2021/2/16,OKC,POR,L 104-115,240,37,85,0.435,27,52,0.519,10,33,0.303,20,27,0.741,104,42,96,0.438,22,49,0.449,20,47,0.426,11,17,0.647,115
307,2021/2/16,POR,OKC,W 115-104,240,42,96,0.438,22,49,0.449,20,47,0.426,11,17,0.647,115,37,85,0.435,27,52,0.519,10,33,0.303,20,27,0.741,104
308,2021/2/16,BRK,PHO,W 128-124,240,47,82,0.573,27,42,0.643,20,40,0.5,14,15,0.933,128,48,88,0.545,32,51,0.627,16,37,0.432,12,12,1,124
309,2021/2/16,PHO,BRK,L 124-128,240,48,88,0.545,32,51,0.627,16,37,0.432,12,12,1,124,47,82,0.573,27,42,0.643,20,40,0.5,14,15,0.933,128
310,2021/2/15,CLE,GSW,L 98-129,240,37,95,0.389,29,65,0.446,8,30,0.267,16,20,0.8,98,46,88,0.523,29,51,0.569,17,37,0.459,20,21,0.952,129
311,2021/2/15,GSW,CLE,W 129-98,240,46,88,0.523,29,51,0.569,17,37,0.459,20,21,0.952,129,37,95,0.389,29,65,0.446,8,30,0.267,16,20,0.8,98
312,2021/2/15,CHI,IND,W 120-112 (OT),265,44,102,0.431,31,69,0.449,13,33,0.394,19,22,0.864,120,39,92,0.424,30,59,0.508,9,33,0.273,25,31,0.806,112
313,2021/2/15,IND,CHI,L 112-120 (OT),265,39,92,0.424,30,59,0.508,9,33,0.273,25,31,0.806,112,44,102,0.431,31,69,0.449,13,33,0.394,19,22,0.864,120
314,2021/2/15,LAC,MIA,W 125-118,240,47,85,0.553,32,53,0.604,15,32,0.469,16,20,0.8,125,46,91,0.505,38,55,0.691,8,36,0.222,18,22,0.818,118
315,2021/2/15,MIA,LAC,L 118-125,240,46,91,0.505,38,55,0.691,8,36,0.222,18,22,0.818,118,47,85,0.553,32,53,0.604,15,32,0.469,16,20,0.8,125
316,2021/2/15,ATL,NYK,L 112-123,240,36,85,0.424,25,52,0.481,11,33,0.333,29,32,0.906,112,42,83,0.506,25,49,0.51,17,34,0.5,22,27,0.815,123
317,2021/2/15,NYK,ATL,W 123-112,240,42,83,0.506,25,49,0.51,17,34,0.5,22,27,0.815,123,36,85,0.424,25,52,0.481,11,33,0.333,29,32,0.906,112
318,2021/2/15,BRK,SAC,W 136-125,240,51,89,0.573,24,42,0.571,27,47,0.574,7,12,0.583,136,51,96,0.531,39,63,0.619,12,33,0.364,11,13,0.846,125
319,2021/2/15,SAC,BRK,L 125-136,240,51,96,0.531,39,63,0.619,12,33,0.364,11,13,0.846,125,51,89,0.573,24,42,0.571,27,47,0.574,7,12,0.583,136
320,2021/2/15,PHI,UTA,L 123-134,240,47,94,0.5,39,71,0.549,8,23,0.348,21,24,0.875,123,45,86,0.523,27,41,0.659,18,45,0.4,26,31,0.839,134
321,2021/2/15,UTA,PHI,W 134-123,240,45,86,0.523,27,41,0.659,18,45,0.4,26,31,0.839,134,47,94,0.5,39,71,0.549,8,23,0.348,21,24,0.875,123
322,2021/2/15,HOU,WAS,L 119-131,240,43,91,0.473,35,54,0.648,8,37,0.216,25,34,0.735,119,48,92,0.522,36,62,0.581,12,30,0.4,23,31,0.742,131
323,2021/2/15,WAS,HOU,W 131-119,240,48,92,0.522,36,62,0.581,12,30,0.4,23,31,0.742,131,43,91,0.473,35,54,0.648,8,37,0.216,25,34,0.735,119
324,2021/2/14,CHO,SAS,L 110-122,240,45,95,0.474,33,61,0.541,12,34,0.353,8,11,0.727,110,48,96,0.5,38,62,0.613,10,34,0.294,16,19,0.842,122
325,2021/2/14,SAS,CHO,W 122-110,240,48,96,0.5,38,62,0.613,10,34,0.294,16,19,0.842,122,45,95,0.474,33,61,0.541,12,34,0.353,8,11,0.727,110
326,2021/2/14,DAL,POR,L 118-121,240,40,81,0.494,26,40,0.65,14,41,0.341,24,25,0.96,118,45,85,0.529,27,45,0.6,18,40,0.45,13,19,0.684,121
327,2021/2/14,POR,DAL,W 121-118,240,45,85,0.529,27,45,0.6,18,40,0.45,13,19,0.684,121,40,81,0.494,26,40,0.65,14,41,0.341,24,25,0.96,118
328,2021/2/14,DEN,LAL,W 122-105,240,39,85,0.459,20,38,0.526,19,47,0.404,25,34,0.735,122,40,87,0.46,34,59,0.576,6,28,0.214,19,29,0.655,105
329,2021/2/14,LAL,DEN,L 105-122,240,40,87,0.46,34,59,0.576,6,28,0.214,19,29,0.655,105,39,85,0.459,20,38,0.526,19,47,0.404,25,34,0.735,122
330,2021/2/14,DET,NOP,W 123-112,240,45,84,0.536,28,49,0.571,17,35,0.486,16,20,0.8,123,40,90,0.444,31,55,0.564,9,35,0.257,23,28,0.821,112
331,2021/2/14,NOP,DET,L 112-123,240,40,90,0.444,31,55,0.564,9,35,0.257,23,28,0.821,112,45,84,0.536,28,49,0.571,17,35,0.486,16,20,0.8,123
332,2021/2/14,CLE,LAC,L 111-128,240,43,93,0.462,36,68,0.529,7,25,0.28,18,25,0.72,111,42,88,0.477,29,58,0.5,13,30,0.433,31,36,0.861,128
333,2021/2/14,LAC,CLE,W 128-111,240,42,88,0.477,29,58,0.5,13,30,0.433,31,36,0.861,128,43,93,0.462,36,68,0.529,7,25,0.28,18,25,0.72,111
334,2021/2/14,MIL,OKC,L 109-114,240,45,97,0.464,32,59,0.542,13,38,0.342,6,9,0.667,109,45,95,0.474,30,59,0.508,15,36,0.417,9,16,0.563,114
335,2021/2/14,OKC,MIL,W 114-109,240,45,95,0.474,30,59,0.508,15,36,0.417,9,16,0.563,114,45,97,0.464,32,59,0.542,13,38,0.342,6,9,0.667,109
336,2021/2/14,ORL,PHO,L 90-109,240,33,89,0.371,27,54,0.5,6,35,0.171,18,22,0.818,90,41,92,0.446,29,55,0.527,12,37,0.324,15,16,0.938,109
337,2021/2/14,PHO,ORL,W 109-90,240,41,92,0.446,29,55,0.527,12,37,0.324,15,16,0.938,109,33,89,0.371,27,54,0.5,6,35,0.171,18,22,0.818,90
338,2021/2/14,MEM,SAC,W 124-110,240,50,94,0.532,41,73,0.562,9,21,0.429,15,19,0.789,124,41,82,0.5,33,49,0.673,8,33,0.242,20,26,0.769,110
339,2021/2/14,SAC,MEM,L 110-124,240,41,82,0.5,33,49,0.673,8,33,0.242,20,26,0.769,110,50,94,0.532,41,73,0.562,9,21,0.429,15,19,0.789,124
340,2021/2/14,MIN,TOR,W 116-112,240,43,82,0.524,27,43,0.628,16,39,0.41,14,19,0.737,116,38,91,0.418,28,58,0.483,10,33,0.303,26,31,0.839,112
341,2021/2/14,TOR,MIN,L 112-116,240,38,91,0.418,28,58,0.483,10,33,0.303,26,31,0.839,112,43,82,0.524,27,43,0.628,16,39,0.41,14,19,0.737,116
342,2021/2/14,BOS,WAS,L 91-104,240,32,90,0.356,23,55,0.418,9,35,0.257,18,30,0.6,91,33,83,0.398,26,53,0.491,7,30,0.233,31,36,0.861,104
343,2021/2/14,WAS,BOS,W 104-91,240,33,83,0.398,26,53,0.491,7,30,0.233,31,36,0.861,104,32,90,0.356,23,55,0.418,9,35,0.257,18,30,0.6,91
344,2021/2/13,ATL,IND,L 113-125,240,43,90,0.478,34,59,0.576,9,31,0.29,18,23,0.783,113,45,89,0.506,33,58,0.569,12,31,0.387,23,27,0.852,125
345,2021/2/13,IND,ATL,W 125-113,240,45,89,0.506,33,58,0.569,12,31,0.387,23,27,0.852,125,43,90,0.478,34,59,0.576,9,31,0.29,18,23,0.783,113
346,2021/2/13,BRK,GSW,W 134-117,240,50,93,0.538,34,54,0.63,16,39,0.41,18,20,0.9,134,44,90,0.489,35,56,0.625,9,34,0.265,20,25,0.8,117
347,2021/2/13,GSW,BRK,L 117-134,240,44,90,0.489,35,56,0.625,9,34,0.265,20,25,0.8,117,50,93,0.538,34,54,0.63,16,39,0.41,18,20,0.9,134
348,2021/2/13,HOU,NYK,L 99-121,240,33,88,0.375,25,45,0.556,8,43,0.186,25,30,0.833,99,45,86,0.523,33,58,0.569,12,28,0.429,19,23,0.826,121
349,2021/2/13,NYK,HOU,W 121-99,240,45,86,0.523,33,58,0.569,12,28,0.429,19,23,0.826,121,33,88,0.375,25,45,0.556,8,43,0.186,25,30,0.833,99
350,2021/2/13,PHI,PHO,L 111-120,240,38,73,0.521,31,56,0.554,7,17,0.412,28,33,0.848,111,48,79,0.608,38,54,0.704,10,25,0.4,14,17,0.824,120
351,2021/2/13,PHO,PHI,W 120-111,240,48,79,0.608,38,54,0.704,10,25,0.4,14,17,0.824,120,38,73,0.521,31,56,0.554,7,17,0.412,28,33,0.848,111
352,2021/2/13,MIA,UTA,L 94-112,240,35,86,0.407,23,50,0.46,12,36,0.333,12,17,0.706,94,39,85,0.459,27,39,0.692,12,46,0.261,22,29,0.759,112
353,2021/2/13,UTA,MIA,W 112-94,240,39,85,0.459,27,39,0.692,12,46,0.261,22,29,0.759,112,35,86,0.407,23,50,0.46,12,36,0.333,12,17,0.706,94
354,2021/2/12,ATL,SAS,L 114-125,240,39,90,0.433,28,58,0.483,11,32,0.344,25,33,0.758,114,45,85,0.529,33,54,0.611,12,31,0.387,23,28,0.821,125
355,2021/2/12,SAS,ATL,W 125-114,240,45,85,0.529,33,54,0.611,12,31,0.387,23,28,0.821,125,39,90,0.433,28,58,0.483,11,32,0.344,25,33,0.758,114
356,2021/2/12,BOS,DET,L 102-108,240,36,82,0.439,28,55,0.509,8,27,0.296,22,30,0.733,102,34,79,0.43,19,41,0.463,15,38,0.395,25,30,0.833,108
357,2021/2/12,DET,BOS,W 108-102,240,34,79,0.43,19,41,0.463,15,38,0.395,25,30,0.833,108,36,82,0.439,28,55,0.509,8,27,0.296,22,30,0.733,102
358,2021/2/12,CHI,LAC,L 106-125,240,40,85,0.471,28,53,0.528,12,32,0.375,14,15,0.933,106,50,86,0.581,37,56,0.661,13,30,0.433,12,15,0.8,125
359,2021/2/12,LAC,CHI,W 125-106,240,50,86,0.581,37,56,0.661,13,30,0.433,12,15,0.8,125,40,85,0.471,28,53,0.528,12,32,0.375,14,15,0.933,106
360,2021/2/12,CHO,MIN,W 120-114,240,44,90,0.489,31,54,0.574,13,36,0.361,19,19,1,120,45,99,0.455,29,58,0.5,16,41,0.39,8,14,0.571,114
361,2021/2/12,MIN,CHO,L 114-120,240,45,99,0.455,29,58,0.5,16,41,0.39,8,14,0.571,114,44,90,0.489,31,54,0.574,13,36,0.361,19,19,1,120
362,2021/2/12,DAL,NOP,W 143-130,240,51,88,0.58,26,43,0.605,25,45,0.556,16,21,0.762,143,48,90,0.533,31,53,0.585,17,37,0.459,17,23,0.739,130
363,2021/2/12,NOP,DAL,L 130-143,240,48,90,0.533,31,53,0.585,17,37,0.459,17,23,0.739,130,51,88,0.58,26,43,0.605,25,45,0.556,16,21,0.762,143
364,2021/2/12,DEN,OKC,W 97-95,240,40,87,0.46,30,47,0.638,10,40,0.25,7,10,0.7,97,36,90,0.4,26,58,0.448,10,32,0.313,13,17,0.765,95
365,2021/2/12,OKC,DEN,L 95-97,240,36,90,0.4,26,58,0.448,10,32,0.313,13,17,0.765,95,40,87,0.46,30,47,0.638,10,40,0.25,7,10,0.7,97
366,2021/2/12,LAL,MEM,W 115-105,240,43,85,0.506,37,55,0.673,6,30,0.2,23,33,0.697,115,39,80,0.488,27,51,0.529,12,29,0.414,15,19,0.789,105
367,2021/2/12,MEM,LAL,L 105-115,240,39,80,0.488,27,51,0.529,12,29,0.414,15,19,0.789,105,43,85,0.506,37,55,0.673,6,30,0.2,23,33,0.697,115
368,2021/2/12,CLE,POR,L 110-129,240,38,87,0.437,30,64,0.469,8,23,0.348,26,37,0.703,110,43,83,0.518,30,48,0.625,13,35,0.371,30,33,0.909,129
369,2021/2/12,POR,CLE,W 129-110,240,43,83,0.518,30,48,0.625,13,35,0.371,30,33,0.909,129,38,87,0.437,30,64,0.469,8,23,0.348,26,37,0.703,110
370,2021/2/12,ORL,SAC,W 123-112,240,46,91,0.505,31,57,0.544,15,34,0.441,16,20,0.8,123,43,83,0.518,31,50,0.62,12,33,0.364,14,19,0.737,112
371,2021/2/12,SAC,ORL,L 112-123,240,43,83,0.518,31,50,0.62,12,33,0.364,14,19,0.737,112,46,91,0.505,31,57,0.544,15,34,0.441,16,20,0.8,123
372,2021/2/12,MIL,UTA,L 115-129,240,42,92,0.457,30,59,0.508,12,33,0.364,19,27,0.704,115,43,82,0.524,29,44,0.659,14,38,0.368,29,34,0.853,129
373,2021/2/12,UTA,MIL,W 129-115,240,43,82,0.524,29,44,0.659,14,38,0.368,29,34,0.853,129,42,92,0.457,30,59,0.508,12,33,0.364,19,27,0.704,115
374,2021/2/12,NYK,WAS,W 109-91,240,44,98,0.449,38,74,0.514,6,24,0.25,15,22,0.682,109,34,89,0.382,25,55,0.455,9,34,0.265,14,20,0.7,91
375,2021/2/12,WAS,NYK,L 91-109,240,34,89,0.382,25,55,0.455,9,34,0.265,14,20,0.7,91,44,98,0.449,38,74,0.514,6,24,0.25,15,22,0.682,109
376,2021/2/11,BOS,TOR,W 120-106,240,39,86,0.453,19,47,0.404,20,39,0.513,22,28,0.786,120,41,83,0.494,32,55,0.582,9,28,0.321,15,19,0.789,106
377,2021/2/11,TOR,BOS,L 106-120,240,41,83,0.494,32,55,0.582,9,28,0.321,15,19,0.789,106,39,86,0.453,19,47,0.404,20,39,0.513,22,28,0.786,120
378,2021/2/11,DET,IND,L 95-111,240,38,85,0.447,33,57,0.579,5,28,0.179,14,19,0.737,95,44,86,0.512,30,55,0.545,14,31,0.452,9,10,0.9,111
379,2021/2/11,IND,DET,W 111-95,240,44,86,0.512,30,55,0.545,14,31,0.452,9,10,0.9,111,38,85,0.447,33,57,0.579,5,28,0.179,14,19,0.737,95
380,2021/2/11,GSW,ORL,W 111-105,240,41,88,0.466,21,38,0.553,20,50,0.4,9,12,0.75,111,38,97,0.392,23,64,0.359,15,33,0.455,14,18,0.778,105
381,2021/2/11,ORL,GSW,L 105-111,240,38,97,0.392,23,64,0.359,15,33,0.455,14,18,0.778,105,41,88,0.466,21,38,0.553,20,50,0.4,9,12,0.75,111
382,2021/2/11,HOU,MIA,L 94-101,240,32,83,0.386,17,33,0.515,15,50,0.3,15,20,0.75,94,34,79,0.43,19,37,0.514,15,42,0.357,18,20,0.9,101
383,2021/2/11,MIA,HOU,W 101-94,240,34,79,0.43,19,37,0.514,15,42,0.357,18,20,0.9,101,32,83,0.386,17,33,0.515,15,50,0.3,15,20,0.75,94
384,2021/2/11,PHI,POR,L 114-118,240,42,86,0.488,36,59,0.61,6,27,0.222,24,29,0.828,114,40,93,0.43,23,55,0.418,17,38,0.447,21,23,0.913,118
385,2021/2/11,POR,PHI,W 118-114,240,40,93,0.43,23,55,0.418,17,38,0.447,21,23,0.913,118,42,86,0.488,36,59,0.61,6,27,0.222,24,29,0.828,114
386,2021/2/10,BRK,IND,W 104-94,240,32,76,0.421,23,45,0.511,9,31,0.29,31,35,0.886,104,36,92,0.391,21,54,0.389,15,38,0.395,7,11,0.636,94
387,2021/2/10,IND,BRK,L 94-104,240,36,92,0.391,21,54,0.389,15,38,0.395,7,11,0.636,94,32,76,0.421,23,45,0.511,9,31,0.29,31,35,0.886,104
388,2021/2/10,CHI,NOP,W 129-116,240,48,81,0.593,23,34,0.676,25,47,0.532,8,11,0.727,129,41,81,0.506,28,45,0.622,13,36,0.361,21,26,0.808,116
389,2021/2/10,NOP,CHI,L 116-129,240,41,81,0.506,28,45,0.622,13,36,0.361,21,26,0.808,116,48,81,0.593,23,34,0.676,25,47,0.532,8,11,0.727,129
390,2021/2/10,ATL,DAL,L 117-118,240,40,88,0.455,26,49,0.531,14,39,0.359,23,28,0.821,117,43,84,0.512,29,49,0.592,14,35,0.4,18,20,0.9,118
391,2021/2/10,DAL,ATL,W 118-117,240,43,84,0.512,29,49,0.592,14,35,0.4,18,20,0.9,118,40,88,0.455,26,49,0.531,14,39,0.359,23,28,0.821,117
392,2021/2/10,CLE,DEN,L 95-133,240,36,94,0.383,28,57,0.491,8,37,0.216,15,20,0.75,95,51,85,0.6,35,49,0.714,16,36,0.444,15,21,0.714,133
393,2021/2/10,DEN,CLE,W 133-95,240,51,85,0.6,35,49,0.714,16,36,0.444,15,21,0.714,133,36,94,0.383,28,57,0.491,8,37,0.216,15,20,0.75,95
394,2021/2/10,LAL,OKC,W 114-113 (OT),265,42,89,0.472,32,54,0.593,10,35,0.286,20,24,0.833,114,47,100,0.47,40,69,0.58,7,31,0.226,12,14,0.857,113
395,2021/2/10,OKC,LAL,L 113-114 (OT),265,47,100,0.47,40,69,0.58,7,31,0.226,12,14,0.857,113,42,89,0.472,32,54,0.593,10,35,0.286,20,24,0.833,114
396,2021/2/10,CHO,MEM,L 114-130,240,45,82,0.549,31,53,0.585,14,29,0.483,10,12,0.833,114,47,94,0.5,24,45,0.533,23,49,0.469,13,18,0.722,130
397,2021/2/10,MEM,CHO,W 130-114,240,47,94,0.5,24,45,0.533,23,49,0.469,13,18,0.722,130,45,82,0.549,31,53,0.585,14,29,0.483,10,12,0.833,114
398,2021/2/10,LAC,MIN,W 119-112,240,41,82,0.5,29,59,0.492,12,23,0.522,25,29,0.862,119,41,95,0.432,26,54,0.481,15,41,0.366,15,19,0.789,112
399,2021/2/10,MIN,LAC,L 112-119,240,41,95,0.432,26,54,0.481,15,41,0.366,15,19,0.789,112,41,82,0.5,29,59,0.492,12,23,0.522,25,29,0.862,119
400,2021/2/10,MIL,PHO,L 124-125,240,43,85,0.506,27,48,0.563,16,37,0.432,22,30,0.733,124,46,87,0.529,31,56,0.554,15,31,0.484,18,25,0.72,125
401,2021/2/10,PHO,MIL,W 125-124,240,46,87,0.529,31,56,0.554,15,31,0.484,18,25,0.72,125,43,85,0.506,27,48,0.563,16,37,0.432,22,30,0.733,124
402,2021/2/10,TOR,WAS,W 137-115,240,49,93,0.527,30,61,0.492,19,32,0.594,20,23,0.87,137,42,93,0.452,30,52,0.577,12,41,0.293,19,23,0.826,115
403,2021/2/10,WAS,TOR,L 115-137,240,42,93,0.452,30,52,0.577,12,41,0.293,19,23,0.826,115,49,93,0.527,30,61,0.492,19,32,0.594,20,23,0.87,137
404,2021/2/9,BRK,DET,L 111-122,240,43,86,0.5,32,56,0.571,11,30,0.367,14,16,0.875,111,47,84,0.56,34,55,0.618,13,29,0.448,15,21,0.714,122
405,2021/2/9,DET,BRK,W 122-111,240,47,84,0.56,34,55,0.618,13,29,0.448,15,21,0.714,122,43,86,0.5,32,56,0.571,11,30,0.367,14,16,0.875,111
406,2021/2/9,MIA,NYK,W 98-96,240,26,70,0.371,12,37,0.324,14,33,0.424,32,39,0.821,98,37,87,0.425,27,59,0.458,10,28,0.357,12,16,0.75,96
407,2021/2/9,NYK,MIA,L 96-98,240,37,87,0.425,27,59,0.458,10,28,0.357,12,16,0.75,96,26,70,0.371,12,37,0.324,14,33,0.424,32,39,0.821,98
408,2021/2/9,HOU,NOP,L 101-130,240,38,91,0.418,25,48,0.521,13,43,0.302,12,21,0.571,101,47,92,0.511,35,61,0.574,12,31,0.387,24,28,0.857,130
409,2021/2/9,NOP,HOU,W 130-101,240,47,92,0.511,35,61,0.574,12,31,0.387,24,28,0.857,130,38,91,0.418,25,48,0.521,13,43,0.302,12,21,0.571,101
410,2021/2/9,ORL,POR,L 97-106,240,37,88,0.42,26,53,0.491,11,35,0.314,12,22,0.545,97,35,90,0.389,17,44,0.386,18,46,0.391,18,19,0.947,106
411,2021/2/9,POR,ORL,W 106-97,240,35,90,0.389,17,44,0.386,18,46,0.391,18,19,0.947,106,37,88,0.42,26,53,0.491,11,35,0.314,12,22,0.545,97
412,2021/2/9,PHI,SAC,W 119-111,240,41,85,0.482,32,65,0.492,9,20,0.45,28,35,0.8,119,43,99,0.434,29,57,0.509,14,42,0.333,11,19,0.579,111
413,2021/2/9,SAC,PHI,L 111-119,240,43,99,0.434,29,57,0.509,14,42,0.333,11,19,0.579,111,41,85,0.482,32,65,0.492,9,20,0.45,28,35,0.8,119
414,2021/2/9,GSW,SAS,W 114-91,240,42,91,0.462,25,51,0.49,17,40,0.425,13,19,0.684,114,32,86,0.372,24,62,0.387,8,24,0.333,19,21,0.905,91
415,2021/2/9,SAS,GSW,L 91-114,240,32,86,0.372,24,62,0.387,8,24,0.333,19,21,0.905,91,42,91,0.462,25,51,0.49,17,40,0.425,13,19,0.684,114
416,2021/2/9,BOS,UTA,L 108-122,240,38,86,0.442,25,57,0.439,13,29,0.448,19,23,0.826,108,40,84,0.476,22,36,0.611,18,48,0.375,24,27,0.889,122
417,2021/2/9,UTA,BOS,W 122-108,240,40,84,0.476,22,36,0.611,18,48,0.375,24,27,0.889,122,38,86,0.442,25,57,0.439,13,29,0.448,19,23,0.826,108
418,2021/2/8,CHI,WAS,L 101-105,240,36,85,0.424,27,55,0.491,9,30,0.3,20,24,0.833,101,36,86,0.419,30,60,0.5,6,26,0.231,27,36,0.75,105
419,2021/2/8,WAS,CHI,W 105-101,240,36,86,0.419,30,60,0.5,6,26,0.231,27,36,0.75,105,36,85,0.424,27,55,0.491,9,30,0.3,20,24,0.833,101
420,2021/2/8,CHO,HOU,W 119-94,240,44,90,0.489,25,49,0.51,19,41,0.463,12,13,0.923,119,35,86,0.407,22,39,0.564,13,47,0.277,11,16,0.688,94
421,2021/2/8,HOU,CHO,L 94-119,240,35,86,0.407,22,39,0.564,13,47,0.277,11,16,0.688,94,44,90,0.489,25,49,0.51,19,41,0.463,12,13,0.923,119
422,2021/2/8,DAL,MIN,W 127-122,240,45,87,0.517,33,53,0.623,12,34,0.353,25,30,0.833,127,42,91,0.462,24,49,0.49,18,42,0.429,20,28,0.714,122
423,2021/2/8,MIN,DAL,L 122-127,240,42,91,0.462,24,49,0.49,18,42,0.429,20,28,0.714,122,45,87,0.517,33,53,0.623,12,34,0.353,25,30,0.833,127
424,2021/2/8,DEN,MIL,L 112-125,240,41,94,0.436,26,58,0.448,15,36,0.417,15,16,0.938,112,45,89,0.506,29,49,0.592,16,40,0.4,19,22,0.864,125
425,2021/2/8,MIL,DEN,W 125-112,240,45,89,0.506,29,49,0.592,16,40,0.4,19,22,0.864,125,41,94,0.436,26,58,0.448,15,36,0.417,15,16,0.938,112
426,2021/2/8,LAL,OKC,W 119-112 (OT),265,44,95,0.463,35,57,0.614,9,38,0.237,22,29,0.759,119,43,110,0.391,31,72,0.431,12,38,0.316,14,19,0.737,112
427,2021/2/8,OKC,LAL,L 112-119 (OT),265,43,110,0.391,31,72,0.431,12,38,0.316,14,19,0.737,112,44,95,0.463,35,57,0.614,9,38,0.237,22,29,0.759,119
428,2021/2/8,MEM,TOR,L 113-128,240,37,87,0.425,24,48,0.5,13,39,0.333,26,29,0.897,113,42,77,0.545,22,40,0.55,20,37,0.541,24,26,0.923,128
429,2021/2/8,TOR,MEM,W 128-113,240,42,77,0.545,22,40,0.55,20,37,0.541,24,26,0.923,128,37,87,0.425,24,48,0.5,13,39,0.333,26,29,0.897,113
430,2021/2/8,CLE,PHO,L 113-119,240,44,86,0.512,36,62,0.581,8,24,0.333,17,25,0.68,113,47,90,0.522,36,66,0.545,11,24,0.458,14,19,0.737,119
431,2021/2/8,PHO,CLE,W 119-113,240,47,90,0.522,36,66,0.545,11,24,0.458,14,19,0.737,119,44,86,0.512,36,62,0.581,8,24,0.333,17,25,0.68,113
432,2021/2/8,GSW,SAS,L 100-105,240,38,86,0.442,25,49,0.51,13,37,0.351,11,15,0.733,100,39,96,0.406,28,65,0.431,11,31,0.355,16,19,0.842,105
433,2021/2/8,SAS,GSW,W 105-100,240,39,96,0.406,28,65,0.431,11,31,0.355,16,19,0.842,105,38,86,0.442,25,49,0.51,13,37,0.351,11,15,0.733,100
434,2021/2/7,CHO,WAS,W 119-97,240,42,99,0.424,27,63,0.429,15,36,0.417,20,26,0.769,119,34,90,0.378,25,50,0.5,9,40,0.225,20,28,0.714,97
435,2021/2/7,WAS,CHO,L 97-119,240,34,90,0.378,25,50,0.5,9,40,0.225,20,28,0.714,97,42,99,0.424,27,63,0.429,15,36,0.417,20,26,0.769,119
436,2021/2/7,IND,UTA,L 95-103,240,37,93,0.398,29,64,0.453,8,29,0.276,13,18,0.722,95,38,92,0.413,25,50,0.5,13,42,0.31,14,21,0.667,103
437,2021/2/7,UTA,IND,W 103-95,240,38,92,0.413,25,50,0.5,13,42,0.31,14,21,0.667,103,37,93,0.398,29,64,0.453,8,29,0.276,13,18,0.722,95
438,2021/2/7,LAC,SAC,L 110-113,240,41,99,0.414,33,71,0.465,8,28,0.286,20,23,0.87,110,46,94,0.489,36,65,0.554,10,29,0.345,11,15,0.733,113
439,2021/2/7,SAC,LAC,W 113-110,240,46,94,0.489,36,65,0.554,10,29,0.345,11,15,0.733,113,41,99,0.414,33,71,0.465,8,28,0.286,20,23,0.87,110
440,2021/2/7,MIA,NYK,W 109-103,240,40,83,0.482,27,48,0.563,13,35,0.371,16,20,0.8,109,38,85,0.447,22,43,0.512,16,42,0.381,11,15,0.733,103
441,2021/2/7,NYK,MIA,L 103-109,240,38,85,0.447,22,43,0.512,16,42,0.381,11,15,0.733,103,40,83,0.482,27,48,0.563,13,35,0.371,16,20,0.8,109
442,2021/2/7,BOS,PHO,L 91-100,240,33,93,0.355,16,49,0.327,17,44,0.386,8,12,0.667,91,40,82,0.488,32,53,0.604,8,29,0.276,12,12,1,100
443,2021/2/7,PHO,BOS,W 100-91,240,40,82,0.488,32,53,0.604,8,29,0.276,12,12,1,100,33,93,0.355,16,49,0.327,17,44,0.386,8,12,0.667,91
444,2021/2/6,ATL,TOR,W 132-121,240,42,74,0.568,23,38,0.605,19,36,0.528,29,33,0.879,132,41,97,0.423,28,59,0.475,13,38,0.342,26,34,0.765,121
445,2021/2/6,TOR,ATL,L 121-132,240,41,97,0.423,28,59,0.475,13,38,0.342,26,34,0.765,121,42,74,0.568,23,38,0.605,19,36,0.528,29,33,0.879,132
446,2021/2/6,CLE,MIL,L 99-124,240,39,86,0.453,33,58,0.569,6,28,0.214,15,21,0.714,99,47,86,0.547,31,52,0.596,16,34,0.471,14,23,0.609,124
447,2021/2/6,MIL,CLE,W 124-99,240,47,86,0.547,31,52,0.596,16,34,0.471,14,23,0.609,124,39,86,0.453,33,58,0.569,6,28,0.214,15,21,0.714,99
448,2021/2/6,DAL,GSW,W 134-132,240,44,96,0.458,23,49,0.469,21,47,0.447,25,30,0.833,134,46,86,0.535,26,41,0.634,20,45,0.444,20,23,0.87,132
449,2021/2/6,GSW,DAL,L 132-134,240,46,86,0.535,26,41,0.634,20,45,0.444,20,23,0.87,132,44,96,0.458,23,49,0.469,21,47,0.447,25,30,0.833,134
450,2021/2/6,HOU,SAS,L 106-111,240,38,88,0.432,26,50,0.52,12,38,0.316,18,25,0.72,106,37,87,0.425,29,62,0.468,8,25,0.32,29,36,0.806,111
451,2021/2/6,SAS,HOU,W 111-106,240,37,87,0.425,29,62,0.468,8,25,0.32,29,36,0.806,111,38,88,0.432,26,50,0.52,12,38,0.316,18,25,0.72,106
452,2021/2/6,DET,LAL,L 129-135 (2OT),290,45,94,0.479,29,52,0.558,16,42,0.381,23,28,0.821,129,51,91,0.56,42,72,0.583,9,19,0.474,24,28,0.857,135
453,2021/2/6,LAL,DET,W 135-129 (2OT),290,51,91,0.56,42,72,0.583,9,19,0.474,24,28,0.857,135,45,94,0.479,29,52,0.558,16,42,0.381,23,28,0.821,129
454,2021/2/6,MEM,NOP,L 109-118,240,40,90,0.444,27,51,0.529,13,39,0.333,16,19,0.842,109,45,87,0.517,30,54,0.556,15,33,0.455,13,21,0.619,118
455,2021/2/6,NOP,MEM,W 118-109,240,45,87,0.517,30,54,0.556,15,33,0.455,13,21,0.619,118,40,90,0.444,27,51,0.529,13,39,0.333,16,19,0.842,109
456,2021/2/6,NYK,POR,W 110-99,240,44,88,0.5,31,58,0.534,13,30,0.433,9,13,0.692,110,37,89,0.416,20,42,0.476,17,47,0.362,8,16,0.5,99
457,2021/2/6,POR,NYK,L 99-110,240,37,89,0.416,20,42,0.476,17,47,0.362,8,16,0.5,99,44,88,0.5,31,58,0.534,13,30,0.433,9,13,0.692,110
458,2021/2/6,MIN,OKC,L 118-120,240,47,93,0.505,35,57,0.614,12,36,0.333,12,22,0.545,118,46,90,0.511,34,57,0.596,12,33,0.364,16,20,0.8,120
459,2021/2/6,OKC,MIN,W 120-118,240,46,90,0.511,34,57,0.596,12,33,0.364,16,20,0.8,120,47,93,0.505,35,57,0.614,12,36,0.333,12,22,0.545,118
460,2021/2/6,CHI,ORL,W 118-92,240,47,91,0.516,32,61,0.525,15,30,0.5,9,13,0.692,118,37,95,0.389,31,68,0.456,6,27,0.222,12,12,1,92
461,2021/2/6,ORL,CHI,L 92-118,240,37,95,0.389,31,68,0.456,6,27,0.222,12,12,1,92,47,91,0.516,32,61,0.525,15,30,0.5,9,13,0.692,118
462,2021/2/6,BRK,PHI,L 108-124,240,39,88,0.443,24,47,0.511,15,41,0.366,15,17,0.882,108,48,94,0.511,38,67,0.567,10,27,0.37,18,22,0.818,124
463,2021/2/6,PHI,BRK,W 124-108,240,48,94,0.511,38,67,0.567,10,27,0.37,18,22,0.818,124,39,88,0.443,24,47,0.511,15,41,0.366,15,17,0.882,108
464,2021/2/6,DEN,SAC,L 114-119,240,45,97,0.464,32,62,0.516,13,35,0.371,11,14,0.786,114,44,91,0.484,30,56,0.536,14,35,0.4,17,24,0.708,119
465,2021/2/6,SAC,DEN,W 119-114,240,44,91,0.484,30,56,0.536,14,35,0.4,17,24,0.708,119,45,97,0.464,32,62,0.516,13,35,0.371,11,14,0.786,114
466,2021/2/5,BRK,TOR,L 117-123,240,39,80,0.488,22,38,0.579,17,42,0.405,22,29,0.759,117,49,97,0.505,36,65,0.554,13,32,0.406,12,14,0.857,123
467,2021/2/5,TOR,BRK,W 123-117,240,49,97,0.505,36,65,0.554,13,32,0.406,12,14,0.857,123,39,80,0.488,22,38,0.579,17,42,0.405,22,29,0.759,117
468,2021/2/5,CHO,UTA,L 121-138,240,48,104,0.462,37,69,0.536,11,35,0.314,14,17,0.824,121,48,87,0.552,22,37,0.595,26,50,0.52,16,18,0.889,138
469,2021/2/5,UTA,CHO,W 138-121,240,48,87,0.552,22,37,0.595,26,50,0.52,16,18,0.889,138,48,104,0.462,37,69,0.536,11,35,0.314,14,17,0.824,121
470,2021/2/5,CLE,MIL,L 105-123,240,41,92,0.446,30,60,0.5,11,32,0.344,12,16,0.75,105,50,97,0.515,43,75,0.573,7,22,0.318,16,22,0.727,123
471,2021/2/5,MIL,CLE,W 123-105,240,50,97,0.515,43,75,0.573,7,22,0.318,16,22,0.727,123,41,92,0.446,30,60,0.5,11,32,0.344,12,16,0.75,105
472,2021/2/5,IND,NOP,L 113-114,240,41,93,0.441,21,51,0.412,20,42,0.476,11,16,0.688,113,41,76,0.539,28,51,0.549,13,25,0.52,19,26,0.731,114
473,2021/2/5,NOP,IND,W 114-113,240,41,76,0.539,28,51,0.549,13,25,0.52,19,26,0.731,114,41,93,0.441,21,51,0.412,20,42,0.476,11,16,0.688,113
474,2021/2/5,BOS,LAC,W 119-115,240,43,90,0.478,27,52,0.519,16,38,0.421,17,21,0.81,119,42,81,0.519,28,49,0.571,14,32,0.438,17,21,0.81,115
475,2021/2/5,LAC,BOS,L 115-119,240,42,81,0.519,28,49,0.571,14,32,0.438,17,21,0.81,115,43,90,0.478,27,52,0.519,16,38,0.421,17,21,0.81,119
476,2021/2/5,MIA,WAS,W 122-95,240,43,86,0.5,27,50,0.54,16,36,0.444,20,23,0.87,122,33,89,0.371,25,56,0.446,8,33,0.242,21,24,0.875,95
477,2021/2/5,WAS,MIA,L 95-122,240,33,89,0.371,25,56,0.446,8,33,0.242,21,24,0.875,95,43,86,0.5,27,50,0.54,16,36,0.444,20,23,0.87,122
478,2021/2/5,MIN,OKC,W 106-103,240,41,94,0.436,25,54,0.463,16,40,0.4,8,9,0.889,106,39,85,0.459,26,51,0.51,13,34,0.382,12,17,0.706,103
479,2021/2/5,OKC,MIN,L 103-106,240,39,85,0.459,26,51,0.51,13,34,0.382,12,17,0.706,103,41,94,0.436,25,54,0.463,16,40,0.4,8,9,0.889,106
480,2021/2/5,CHI,ORL,L 119-123,240,46,96,0.479,37,66,0.561,9,30,0.3,18,20,0.9,119,42,81,0.519,31,54,0.574,11,27,0.407,28,37,0.757,123
481,2021/2/5,ORL,CHI,W 123-119,240,42,81,0.519,31,54,0.574,11,27,0.407,28,37,0.757,123,46,96,0.479,37,66,0.561,9,30,0.3,18,20,0.9,119
482,2021/2/5,DET,PHO,L 92-109,240,34,91,0.374,27,55,0.491,7,36,0.194,17,28,0.607,92,42,85,0.494,30,53,0.566,12,32,0.375,13,16,0.813,109
483,2021/2/5,PHO,DET,W 109-92,240,42,85,0.494,30,53,0.566,12,32,0.375,13,16,0.813,109,34,91,0.374,27,55,0.491,7,36,0.194,17,28,0.607,92
484,2021/2/4,ATL,UTA,L 91-112,240,32,98,0.327,23,67,0.343,9,31,0.29,18,19,0.947,91,44,91,0.484,31,64,0.484,13,27,0.481,11,13,0.846,112
485,2021/2/4,UTA,ATL,W 112-91,240,44,91,0.484,31,64,0.484,13,27,0.481,11,13,0.846,112,32,98,0.327,23,67,0.343,9,31,0.29,18,19,0.947,91
486,2021/2/4,DAL,GSW,L 116-147,240,38,92,0.413,18,42,0.429,20,50,0.4,20,23,0.87,116,51,89,0.573,29,46,0.63,22,43,0.512,23,27,0.852,147
487,2021/2/4,GSW,DAL,W 147-116,240,51,89,0.573,29,46,0.63,22,43,0.512,23,27,0.852,147,38,92,0.413,18,42,0.429,20,50,0.4,20,23,0.87,116
488,2021/2/4,DEN,LAL,L 93-114,240,36,92,0.391,28,64,0.438,8,28,0.286,13,15,0.867,93,46,81,0.568,38,57,0.667,8,24,0.333,14,22,0.636,114
489,2021/2/4,LAL,DEN,W 114-93,240,46,81,0.568,38,57,0.667,8,24,0.333,14,22,0.636,114,36,92,0.391,28,64,0.438,8,28,0.286,13,15,0.867,93
490,2021/2/4,HOU,MEM,W 115-103,240,41,87,0.471,22,42,0.524,19,45,0.422,14,17,0.824,115,37,87,0.425,25,52,0.481,12,35,0.343,17,24,0.708,103
491,2021/2/4,MEM,HOU,L 103-115,240,37,87,0.425,25,52,0.481,12,35,0.343,17,24,0.708,103,41,87,0.471,22,42,0.524,19,45,0.422,14,17,0.824,115
492,2021/2/4,PHI,POR,L 105-121,240,39,81,0.481,32,54,0.593,7,27,0.259,20,24,0.833,105,45,98,0.459,32,67,0.478,13,31,0.419,18,23,0.783,121
493,2021/2/4,POR,PHI,W 121-105,240,45,98,0.459,32,67,0.478,13,31,0.419,18,23,0.783,121,39,81,0.481,32,54,0.593,7,27,0.259,20,24,0.833,105
494,2021/2/3,ATL,DAL,L 116-122,240,45,90,0.5,31,52,0.596,14,38,0.368,12,17,0.706,116,43,93,0.462,30,53,0.566,13,40,0.325,23,25,0.92,122
495,2021/2/3,DAL,ATL,W 122-116,240,43,93,0.462,30,53,0.566,13,40,0.325,23,25,0.92,122,45,90,0.5,31,52,0.596,14,38,0.368,12,17,0.706,116
496,2021/2/3,CHI,NYK,L 103-107,240,43,88,0.489,37,52,0.712,6,36,0.167,11,16,0.688,103,43,89,0.483,32,67,0.478,11,22,0.5,10,15,0.667,107
497,2021/2/3,NYK,CHI,W 107-103,240,43,89,0.483,32,67,0.478,11,22,0.5,10,15,0.667,107,43,88,0.489,37,52,0.712,6,36,0.167,11,16,0.688,103
498,2021/2/3,CHO,PHI,L 111-118,240,39,87,0.448,25,50,0.5,14,37,0.378,19,23,0.826,111,41,79,0.519,31,55,0.564,10,24,0.417,26,32,0.813,118
499,2021/2/3,PHI,CHO,W 118-111,240,41,79,0.519,31,55,0.564,10,24,0.417,26,32,0.813,118,39,87,0.448,25,50,0.5,14,37,0.378,19,23,0.826,111
500,2021/2/3,CLE,LAC,L 99-121,240,41,92,0.446,37,82,0.451,4,10,0.4,13,17,0.765,99,44,79,0.557,24,45,0.533,20,34,0.588,13,17,0.765,121
501,2021/2/3,LAC,CLE,W 121-99,240,44,79,0.557,24,45,0.533,20,34,0.588,13,17,0.765,121,41,92,0.446,37,82,0.451,4,10,0.4,13,17,0.765,99
502,2021/2/3,MIA,WAS,L 100-103,240,36,83,0.434,24,48,0.5,12,35,0.343,16,22,0.727,100,35,84,0.417,20,47,0.426,15,37,0.405,18,25,0.72,103
503,2021/2/3,WAS,MIA,W 103-100,240,35,84,0.417,20,47,0.426,15,37,0.405,18,25,0.72,103,36,83,0.434,24,48,0.5,12,35,0.343,16,22,0.727,100
504,2021/2/3,IND,MIL,L 110-130,240,43,95,0.453,32,61,0.525,11,34,0.324,13,15,0.867,110,48,102,0.471,27,54,0.5,21,48,0.438,13,14,0.929,130
505,2021/2/3,MIL,IND,W 130-110,240,48,102,0.471,27,54,0.5,21,48,0.438,13,14,0.929,130,43,95,0.453,32,61,0.525,11,34,0.324,13,15,0.867,110
506,2021/2/3,NOP,PHO,W 123-101,240,46,90,0.511,32,57,0.561,14,33,0.424,17,21,0.81,123,38,82,0.463,30,47,0.638,8,35,0.229,17,20,0.85,101
507,2021/2/3,PHO,NOP,L 101-123,240,38,82,0.463,30,47,0.638,8,35,0.229,17,20,0.85,101,46,90,0.511,32,57,0.561,14,33,0.424,17,21,0.81,123
508,2021/2/3,HOU,OKC,L 87-104,240,33,86,0.384,21,40,0.525,12,46,0.261,9,13,0.692,87,36,83,0.434,26,50,0.52,10,33,0.303,22,26,0.846,104
509,2021/2/3,OKC,HOU,W 104-87,240,36,83,0.434,26,50,0.52,10,33,0.303,22,26,0.846,104,33,86,0.384,21,40,0.525,12,46,0.261,9,13,0.692,87
510,2021/2/3,BOS,SAC,L 111-116,240,39,86,0.453,28,53,0.528,11,33,0.333,22,29,0.759,111,42,92,0.457,29,55,0.527,13,37,0.351,19,23,0.826,116
511,2021/2/3,SAC,BOS,W 116-111,240,42,92,0.457,29,55,0.527,13,37,0.351,19,23,0.826,116,39,86,0.453,28,53,0.528,11,33,0.333,22,29,0.759,111
512,2021/2/3,MIN,SAS,L 108-111,240,43,94,0.457,30,61,0.492,13,33,0.394,9,11,0.818,108,43,96,0.448,36,70,0.514,7,26,0.269,18,24,0.75,111
513,2021/2/3,SAS,MIN,W 111-108,240,43,96,0.448,36,70,0.514,7,26,0.269,18,24,0.75,111,43,94,0.457,30,61,0.492,13,33,0.394,9,11,0.818,108
514,2021/2/2,BRK,LAC,W 124-120,240,45,79,0.57,32,48,0.667,13,31,0.419,21,26,0.808,124,45,99,0.455,30,63,0.476,15,36,0.417,15,17,0.882,120
515,2021/2/2,LAC,BRK,L 120-124,240,45,99,0.455,30,63,0.476,15,36,0.417,15,17,0.882,120,45,79,0.57,32,48,0.667,13,31,0.419,21,26,0.808,124
516,2021/2/2,BOS,GSW,W 111-107,240,39,84,0.464,26,50,0.52,13,34,0.382,20,27,0.741,111,38,83,0.458,23,46,0.5,15,37,0.405,16,23,0.696,107
517,2021/2/2,GSW,BOS,L 107-111,240,38,83,0.458,23,46,0.5,15,37,0.405,16,23,0.696,107,39,84,0.464,26,50,0.52,13,34,0.382,20,27,0.741,111
518,2021/2/2,IND,MEM,W 134-116,240,49,82,0.598,33,53,0.623,16,29,0.552,20,29,0.69,134,42,93,0.452,33,68,0.485,9,25,0.36,23,24,0.958,116
519,2021/2/2,MEM,IND,L 116-134,240,42,93,0.452,33,68,0.485,9,25,0.36,23,24,0.958,116,49,82,0.598,33,53,0.623,16,29,0.552,20,29,0.69,134
520,2021/2/2,ORL,TOR,L 108-123,240,41,89,0.461,27,51,0.529,14,38,0.368,12,14,0.857,108,40,83,0.482,20,38,0.526,20,45,0.444,23,25,0.92,123
521,2021/2/2,TOR,ORL,W 123-108,240,40,83,0.482,20,38,0.526,20,45,0.444,23,25,0.92,123,41,89,0.461,27,51,0.529,14,38,0.368,12,14,0.857,108
522,2021/2/2,DET,UTA,L 105-117,240,39,93,0.419,30,66,0.455,9,27,0.333,18,20,0.9,105,38,82,0.463,22,40,0.55,16,42,0.381,25,29,0.862,117
523,2021/2/2,UTA,DET,W 117-105,240,38,82,0.463,22,40,0.55,16,42,0.381,25,29,0.862,117,39,93,0.419,30,66,0.455,9,27,0.333,18,20,0.9,105
524,2021/2/2,POR,WAS,W 132-121,240,44,95,0.463,23,49,0.469,21,46,0.457,23,23,1,132,46,83,0.554,30,43,0.698,16,40,0.4,13,17,0.765,121
525,2021/2/2,WAS,POR,L 121-132,240,46,83,0.554,30,43,0.698,16,40,0.4,13,17,0.765,121,44,95,0.463,23,49,0.469,21,46,0.457,23,23,1,132
526,2021/2/1,ATL,LAL,L 99-107,240,37,78,0.474,26,49,0.531,11,29,0.379,14,17,0.824,99,40,77,0.519,33,54,0.611,7,23,0.304,20,24,0.833,107
527,2021/2/1,LAL,ATL,W 107-99,240,40,77,0.519,33,54,0.611,7,23,0.304,20,24,0.833,107,37,78,0.474,26,49,0.531,11,29,0.379,14,17,0.824,99
528,2021/2/1,CHI,NYK,W 110-102,240,42,88,0.477,31,54,0.574,11,34,0.324,15,20,0.75,110,37,87,0.425,31,58,0.534,6,29,0.207,22,26,0.846,102
529,2021/2/1,NYK,CHI,L 102-110,240,37,87,0.425,31,58,0.534,6,29,0.207,22,26,0.846,102,42,88,0.477,31,54,0.574,11,34,0.324,15,20,0.75,110
530,2021/2/1,CLE,MIN,W 100-98,240,35,84,0.417,28,62,0.452,7,22,0.318,23,31,0.742,100,40,102,0.392,29,64,0.453,11,38,0.289,7,11,0.636,98
531,2021/2/1,MIN,CLE,L 98-100,240,40,102,0.392,29,64,0.453,11,38,0.289,7,11,0.636,98,35,84,0.417,28,62,0.452,7,22,0.318,23,31,0.742,100
532,2021/2/1,DAL,PHO,L 108-109,240,37,86,0.43,27,54,0.5,10,32,0.313,24,25,0.96,108,43,92,0.467,30,57,0.526,13,35,0.371,10,12,0.833,109
533,2021/2/1,PHO,DAL,W 109-108,240,43,92,0.467,30,57,0.526,13,35,0.371,10,12,0.833,109,37,86,0.43,27,54,0.5,10,32,0.313,24,25,0.96,108
534,2021/2/1,CHO,MIA,W 129-121 (OT),265,43,95,0.453,22,54,0.407,21,41,0.512,22,26,0.846,129,43,91,0.473,24,45,0.533,19,46,0.413,16,25,0.64,121
535,2021/2/1,MIA,CHO,L 121-129 (OT),265,43,91,0.473,24,45,0.533,19,46,0.413,16,25,0.64,121,43,95,0.453,22,54,0.407,21,41,0.512,22,26,0.846,129
536,2021/2/1,MIL,POR,W 134-106,240,53,96,0.552,32,54,0.593,21,42,0.5,7,12,0.583,134,39,104,0.375,24,62,0.387,15,42,0.357,13,13,1,106
537,2021/2/1,POR,MIL,L 106-134,240,39,104,0.375,24,62,0.387,15,42,0.357,13,13,1,106,53,96,0.552,32,54,0.593,21,42,0.5,7,12,0.583,134
538,2021/2/1,NOP,SAC,L 109-118,240,40,101,0.396,31,71,0.437,9,30,0.3,20,24,0.833,109,42,88,0.477,28,45,0.622,14,43,0.326,20,26,0.769,118
539,2021/2/1,SAC,NOP,W 118-109,240,42,88,0.477,28,45,0.622,14,43,0.326,20,26,0.769,118,40,101,0.396,31,71,0.437,9,30,0.3,20,24,0.833,109
540,2021/2/1,HOU,OKC,W 136-106,240,49,102,0.48,21,50,0.42,28,52,0.538,10,11,0.909,136,39,89,0.438,26,55,0.473,13,34,0.382,15,19,0.789,106
541,2021/2/1,OKC,HOU,L 106-136,240,39,89,0.438,26,55,0.473,13,34,0.382,15,19,0.789,106,49,102,0.48,21,50,0.42,28,52,0.538,10,11,0.909,136
542,2021/2/1,MEM,SAS,W 133-102,240,52,93,0.559,37,63,0.587,15,30,0.5,14,18,0.778,133,37,89,0.416,24,52,0.462,13,37,0.351,15,22,0.682,102
543,2021/2/1,SAS,MEM,L 102-133,240,37,89,0.416,24,52,0.462,13,37,0.351,15,22,0.682,102,52,93,0.559,37,63,0.587,15,30,0.5,14,18,0.778,133
544,2021/1/31,DEN,UTA,W 128-117,240,47,87,0.54,29,59,0.492,18,28,0.643,16,19,0.842,128,32,75,0.427,12,28,0.429,20,47,0.426,33,39,0.846,117
545,2021/1/31,UTA,DEN,L 117-128,240,32,75,0.427,12,28,0.429,20,47,0.426,33,39,0.846,117,47,87,0.54,29,59,0.492,18,28,0.643,16,19,0.842,128
546,2021/1/31,IND,PHI,L 110-119,240,41,84,0.488,31,56,0.554,10,28,0.357,18,22,0.818,110,45,92,0.489,37,66,0.561,8,26,0.308,21,31,0.677,119
547,2021/1/31,PHI,IND,W 119-110,240,45,92,0.489,37,66,0.561,8,26,0.308,21,31,0.677,119,41,84,0.488,31,56,0.554,10,28,0.357,18,22,0.818,110
548,2021/1/31,CLE,MIN,L 104-109,240,41,84,0.488,37,68,0.544,4,16,0.25,18,23,0.783,104,41,91,0.451,25,51,0.49,16,40,0.4,11,15,0.733,109
549,2021/1/31,MIN,CLE,W 109-104,240,41,91,0.451,25,51,0.49,16,40,0.4,11,15,0.733,109,41,84,0.488,37,68,0.544,4,16,0.25,18,23,0.783,104
550,2021/1/31,LAC,NYK,W 129-115,240,44,81,0.543,27,43,0.628,17,38,0.447,24,28,0.857,129,41,85,0.482,31,58,0.534,10,27,0.37,23,28,0.821,115
551,2021/1/31,NYK,LAC,L 115-129,240,41,85,0.482,31,58,0.534,10,27,0.37,23,28,0.821,115,44,81,0.543,27,43,0.628,17,38,0.447,24,28,0.857,129
552,2021/1/31,ORL,TOR,L 102-115,240,33,82,0.402,20,46,0.435,13,36,0.361,23,28,0.821,102,41,90,0.456,29,51,0.569,12,39,0.308,21,22,0.955,115
553,2021/1/31,TOR,ORL,W 115-102,240,41,90,0.456,29,51,0.569,12,39,0.308,21,22,0.955,115,33,82,0.402,20,46,0.435,13,36,0.361,23,28,0.821,102
554,2021/1/31,BRK,WAS,L 146-149,240,50,88,0.568,31,52,0.596,19,36,0.528,27,33,0.818,146,56,108,0.519,44,69,0.638,12,39,0.308,25,32,0.781,149
555,2021/1/31,WAS,BRK,W 149-146,240,56,108,0.519,44,69,0.638,12,39,0.308,25,32,0.781,149,50,88,0.568,31,52,0.596,19,36,0.528,27,33,0.818,146
556,2021/1/30,BOS,LAL,L 95-96,240,40,82,0.488,34,61,0.557,6,21,0.286,9,14,0.643,95,37,84,0.44,28,53,0.528,9,31,0.29,13,19,0.684,96
557,2021/1/30,LAL,BOS,W 96-95,240,37,84,0.44,28,53,0.528,9,31,0.29,13,19,0.684,96,40,82,0.488,34,61,0.557,6,21,0.286,9,14,0.643,95
558,2021/1/30,CHI,POR,L 122-123,240,43,85,0.506,22,40,0.55,21,45,0.467,15,15,1,122,45,88,0.511,28,46,0.609,17,42,0.405,16,19,0.842,123
559,2021/1/30,POR,CHI,W 123-122,240,45,88,0.511,28,46,0.609,17,42,0.405,16,19,0.842,123,43,85,0.506,22,40,0.55,21,45,0.467,15,15,1,122
560,2021/1/30,CHO,MIL,W 126-114,240,44,92,0.478,23,48,0.479,21,44,0.477,17,20,0.85,126,40,82,0.488,22,37,0.595,18,45,0.4,16,24,0.667,114
561,2021/1/30,MIL,CHO,L 114-126,240,40,82,0.488,22,37,0.595,18,45,0.4,16,24,0.667,114,44,92,0.478,23,48,0.479,21,44,0.477,17,20,0.85,126
562,2021/1/30,DAL,PHO,L 105-111,240,44,83,0.53,35,54,0.648,9,29,0.31,8,14,0.571,105,37,81,0.457,27,59,0.458,10,22,0.455,27,31,0.871,111
563,2021/1/30,PHO,DAL,W 111-105,240,37,81,0.457,27,59,0.458,10,22,0.455,27,31,0.871,111,44,83,0.53,35,54,0.648,9,29,0.31,8,14,0.571,105
564,2021/1/30,DET,GSW,L 91-118,240,29,77,0.377,20,41,0.488,9,36,0.25,24,32,0.75,91,47,89,0.528,30,53,0.566,17,36,0.472,7,10,0.7,118
565,2021/1/30,GSW,DET,W 118-91,240,47,89,0.528,30,53,0.566,17,36,0.472,7,10,0.7,118,29,77,0.377,20,41,0.488,9,36,0.25,24,32,0.75,91
566,2021/1/30,MIA,SAC,W 105-104,240,36,77,0.468,25,45,0.556,11,32,0.344,22,26,0.846,105,41,85,0.482,24,40,0.6,17,45,0.378,5,11,0.455,104
567,2021/1/30,SAC,MIA,L 104-105,240,41,85,0.482,24,40,0.6,17,45,0.378,5,11,0.455,104,36,77,0.468,25,45,0.556,11,32,0.344,22,26,0.846,105
568,2021/1/30,HOU,NOP,W 126-112,240,45,92,0.489,25,46,0.543,20,46,0.435,16,20,0.8,126,41,91,0.451,29,50,0.58,12,41,0.293,18,29,0.621,112
569,2021/1/30,NOP,HOU,L 112-126,240,41,91,0.451,29,50,0.58,12,41,0.293,18,29,0.621,112,45,92,0.489,25,46,0.543,20,46,0.435,16,20,0.8,126
570,2021/1/30,MEM,SAS,W 129-112,240,51,91,0.56,34,56,0.607,17,35,0.486,10,15,0.667,129,39,83,0.47,26,54,0.481,13,29,0.448,21,26,0.808,112
571,2021/1/30,SAS,MEM,L 112-129,240,39,83,0.47,26,54,0.481,13,29,0.448,21,26,0.808,112,51,91,0.56,34,56,0.607,17,35,0.486,10,15,0.667,129
572,2021/1/29,CHO,IND,W 108-105,240,43,85,0.506,27,48,0.563,16,37,0.432,6,9,0.667,108,42,87,0.483,31,52,0.596,11,35,0.314,10,13,0.769,105
573,2021/1/29,IND,CHO,L 105-108,240,42,87,0.483,31,52,0.596,11,35,0.314,10,13,0.769,105,43,85,0.506,27,48,0.563,16,37,0.432,6,9,0.667,108
574,2021/1/29,MIN,PHI,L 94-118,240,35,82,0.427,25,49,0.51,10,33,0.303,14,18,0.778,94,39,87,0.448,31,71,0.437,8,16,0.5,32,38,0.842,118
575,2021/1/29,PHI,MIN,W 118-94,240,39,87,0.448,31,71,0.437,8,16,0.5,32,38,0.842,118,35,82,0.427,25,49,0.51,10,33,0.303,14,18,0.778,94
576,2021/1/29,MIL,NOP,L 126-131,240,48,96,0.5,35,61,0.574,13,35,0.371,17,22,0.773,126,45,96,0.469,24,48,0.5,21,48,0.438,20,28,0.714,131
577,2021/1/29,NOP,MIL,W 131-126,240,45,96,0.469,24,48,0.5,21,48,0.438,20,28,0.714,131,48,96,0.5,35,61,0.574,13,35,0.371,17,22,0.773,126
578,2021/1/29,CLE,NYK,L 81-102,240,29,84,0.345,21,58,0.362,8,26,0.308,15,18,0.833,81,39,80,0.488,29,53,0.547,10,27,0.37,14,16,0.875,102
579,2021/1/29,NYK,CLE,W 102-81,240,39,80,0.488,29,53,0.547,10,27,0.37,14,16,0.875,102,29,84,0.345,21,58,0.362,8,26,0.308,15,18,0.833,81
580,2021/1/29,BRK,OKC,W 147-125,240,57,100,0.57,38,55,0.691,19,45,0.422,14,16,0.875,147,40,86,0.465,24,48,0.5,16,38,0.421,29,34,0.853,125
581,2021/1/29,OKC,BRK,L 125-147,240,40,86,0.465,24,48,0.5,16,38,0.421,29,34,0.853,125,57,100,0.57,38,55,0.691,19,45,0.422,14,16,0.875,147
582,2021/1/29,LAC,ORL,W 116-90,240,46,94,0.489,33,57,0.579,13,37,0.351,11,11,1,116,32,89,0.36,22,56,0.393,10,33,0.303,16,18,0.889,90
583,2021/1/29,ORL,LAC,L 90-116,240,32,89,0.36,22,56,0.393,10,33,0.303,16,18,0.889,90,46,94,0.489,33,57,0.579,13,37,0.351,11,11,1,116
584,2021/1/29,DEN,SAS,L 109-119,240,41,78,0.526,27,47,0.574,14,31,0.452,13,20,0.65,109,44,81,0.543,34,58,0.586,10,23,0.435,21,26,0.808,119
585,2021/1/29,SAS,DEN,W 119-109,240,44,81,0.543,34,58,0.586,10,23,0.435,21,26,0.808,119,41,78,0.526,27,47,0.574,14,31,0.452,13,20,0.65,109
586,2021/1/29,SAC,TOR,W 126-124,240,43,78,0.551,27,42,0.643,16,36,0.444,24,31,0.774,126,42,86,0.488,29,54,0.537,13,32,0.406,27,33,0.818,124
587,2021/1/29,TOR,SAC,L 124-126,240,42,86,0.488,29,54,0.537,13,32,0.406,27,33,0.818,124,43,78,0.551,27,42,0.643,16,36,0.444,24,31,0.774,126
588,2021/1/29,DAL,UTA,L 101-120,240,37,86,0.43,28,53,0.528,9,33,0.273,18,27,0.667,101,38,87,0.437,18,39,0.462,20,48,0.417,24,26,0.923,120
589,2021/1/29,UTA,DAL,W 120-101,240,38,87,0.437,18,39,0.462,20,48,0.417,24,26,0.923,120,37,86,0.43,28,53,0.528,9,33,0.273,18,27,0.667,101
590,2021/1/29,ATL,WAS,W 116-100,240,39,87,0.448,27,50,0.54,12,37,0.324,26,34,0.765,116,31,85,0.365,24,57,0.421,7,28,0.25,31,38,0.816,100
591,2021/1/29,WAS,ATL,L 100-116,240,31,85,0.365,24,57,0.421,7,28,0.25,31,38,0.816,100,39,87,0.448,27,50,0.54,12,37,0.324,26,34,0.765,116
592,2021/1/28,DET,LAL,W 107-92,240,40,87,0.46,26,51,0.51,14,36,0.389,13,13,1,107,36,88,0.409,24,60,0.4,12,28,0.429,8,12,0.667,92
593,2021/1/28,LAL,DET,L 92-107,240,36,88,0.409,24,60,0.4,12,28,0.429,8,12,0.667,92,40,87,0.46,26,51,0.51,14,36,0.389,13,13,1,107
594,2021/1/28,HOU,POR,W 104-101,240,38,90,0.422,25,43,0.581,13,47,0.277,15,18,0.833,104,39,93,0.419,22,52,0.423,17,41,0.415,6,8,0.75,101
595,2021/1/28,POR,HOU,L 101-104,240,39,93,0.419,22,52,0.423,17,41,0.415,6,8,0.75,101,38,90,0.422,25,43,0.581,13,47,0.277,15,18,0.833,104
596,2021/1/28,LAC,MIA,W 109-105,240,36,87,0.414,19,45,0.422,17,42,0.405,20,22,0.909,109,40,90,0.444,27,57,0.474,13,33,0.394,12,15,0.8,105
597,2021/1/28,MIA,LAC,L 105-109,240,40,90,0.444,27,57,0.474,13,33,0.394,12,15,0.8,105,36,87,0.414,19,45,0.422,17,42,0.405,20,22,0.909,109
598,2021/1/28,GSW,PHO,L 93-114,240,38,99,0.384,27,61,0.443,11,38,0.289,6,8,0.75,93,41,88,0.466,30,56,0.536,11,32,0.344,21,23,0.913,114
599,2021/1/28,PHO,GSW,W 114-93,240,41,88,0.466,30,56,0.536,11,32,0.344,21,23,0.913,114,38,99,0.384,27,61,0.443,11,38,0.289,6,8,0.75,93
600,2021/1/27,ATL,BRK,L 128-132 (OT),265,45,94,0.479,32,61,0.525,13,33,0.394,25,28,0.893,128,52,98,0.531,41,66,0.621,11,32,0.344,17,20,0.85,132
601,2021/1/27,BRK,ATL,W 132-128 (OT),265,52,98,0.531,41,66,0.621,11,32,0.344,17,20,0.85,132,45,94,0.479,32,61,0.525,13,33,0.394,25,28,0.893,128
602,2021/1/27,CHO,IND,L 106-116,240,37,90,0.411,24,52,0.462,13,38,0.342,19,21,0.905,106,45,88,0.511,29,48,0.604,16,40,0.4,10,12,0.833,116
603,2021/1/27,IND,CHO,W 116-106,240,45,88,0.511,29,48,0.604,16,40,0.4,10,12,0.833,116,37,90,0.411,24,52,0.462,13,38,0.342,19,21,0.905,106
604,2021/1/27,CLE,DET,W 122-107,240,47,87,0.54,36,66,0.545,11,21,0.524,17,23,0.739,122,37,82,0.451,26,55,0.473,11,27,0.407,22,29,0.759,107
605,2021/1/27,DET,CLE,L 107-122,240,37,82,0.451,26,55,0.473,11,27,0.407,22,29,0.759,107,47,87,0.54,36,66,0.545,11,21,0.524,17,23,0.739,122
606,2021/1/27,GSW,MIN,W 123-111,240,45,85,0.529,30,51,0.588,15,34,0.441,18,23,0.783,123,37,87,0.425,23,51,0.451,14,36,0.389,23,33,0.697,111
607,2021/1/27,MIN,GSW,L 111-123,240,37,87,0.425,23,51,0.451,14,36,0.389,23,33,0.697,111,45,85,0.529,30,51,0.588,15,34,0.441,18,23,0.783,123
608,2021/1/27,DEN,MIA,W 109-82,240,42,92,0.457,28,49,0.571,14,43,0.326,11,11,1,109,30,80,0.375,17,35,0.486,13,45,0.289,9,11,0.818,82
609,2021/1/27,MIA,DEN,L 82-109,240,30,80,0.375,17,35,0.486,13,45,0.289,9,11,0.818,82,42,92,0.457,28,49,0.571,14,43,0.326,11,11,1,109
610,2021/1/27,NOP,WAS,W 124-106,240,46,89,0.517,29,46,0.63,17,43,0.395,15,24,0.625,124,37,92,0.402,24,54,0.444,13,38,0.342,19,21,0.905,106
611,2021/1/27,WAS,NOP,L 106-124,240,37,92,0.402,24,54,0.444,13,38,0.342,19,21,0.905,106,46,89,0.517,29,46,0.63,17,43,0.395,15,24,0.625,124
612,2021/1/27,ORL,SAC,L 107-121,240,40,96,0.417,30,70,0.429,10,26,0.385,17,18,0.944,107,45,92,0.489,31,59,0.525,14,33,0.424,17,26,0.654,121
613,2021/1/27,SAC,ORL,W 121-107,240,45,92,0.489,31,59,0.525,14,33,0.424,17,26,0.654,121,40,96,0.417,30,70,0.429,10,26,0.385,17,18,0.944,107
614,2021/1/27,LAL,PHI,L 106-107,240,41,86,0.477,33,62,0.532,8,24,0.333,16,25,0.64,106,41,85,0.482,32,60,0.533,9,25,0.36,16,26,0.615,107
615,2021/1/27,PHI,LAL,W 107-106,240,41,85,0.482,32,60,0.533,9,25,0.36,16,26,0.615,107,41,86,0.477,33,62,0.532,8,24,0.333,16,25,0.64,106
616,2021/1/27,OKC,PHO,W 102-97,240,38,85,0.447,22,45,0.489,16,40,0.4,10,14,0.714,102,36,95,0.379,21,52,0.404,15,43,0.349,10,12,0.833,97
617,2021/1/27,PHO,OKC,L 97-102,240,36,95,0.379,21,52,0.404,15,43,0.349,10,12,0.833,97,38,85,0.447,22,45,0.489,16,40,0.4,10,14,0.714,102
618,2021/1/27,BOS,SAS,L 106-110,240,42,98,0.429,32,68,0.471,10,30,0.333,12,14,0.857,106,46,82,0.561,38,54,0.704,8,28,0.286,10,16,0.625,110
619,2021/1/27,SAS,BOS,W 110-106,240,46,82,0.561,38,54,0.704,8,28,0.286,10,16,0.625,110,42,98,0.429,32,68,0.471,10,30,0.333,12,14,0.857,106
620,2021/1/27,MIL,TOR,W 115-108,240,40,93,0.43,24,49,0.49,16,44,0.364,19,26,0.731,115,38,94,0.404,16,39,0.41,22,55,0.4,10,12,0.833,108
621,2021/1/27,TOR,MIL,L 108-115,240,38,94,0.404,16,39,0.41,22,55,0.4,10,12,0.833,108,40,93,0.43,24,49,0.49,16,44,0.364,19,26,0.731,115
622,2021/1/27,DAL,UTA,L 104-116,240,42,91,0.462,30,56,0.536,12,35,0.343,8,9,0.889,104,42,91,0.462,26,50,0.52,16,41,0.39,16,21,0.762,116
623,2021/1/27,UTA,DAL,W 116-104,240,42,91,0.462,26,50,0.52,16,41,0.39,16,21,0.762,116,42,91,0.462,30,56,0.536,12,35,0.343,8,9,0.889,104
624,2021/1/26,ATL,LAC,W 108-99,240,37,80,0.463,27,54,0.5,10,26,0.385,24,25,0.96,108,36,89,0.404,28,63,0.444,8,26,0.308,19,22,0.864,99
625,2021/1/26,LAC,ATL,L 99-108,240,36,89,0.404,28,63,0.444,8,26,0.308,19,22,0.864,99,37,80,0.463,27,54,0.5,10,26,0.385,24,25,0.96,108
626,2021/1/26,HOU,WAS,W 107-88,240,37,88,0.42,25,51,0.49,12,37,0.324,21,29,0.724,107,33,84,0.393,28,58,0.483,5,26,0.192,17,23,0.739,88
627,2021/1/26,WAS,HOU,L 88-107,240,33,84,0.393,28,58,0.483,5,26,0.192,17,23,0.739,88,37,88,0.42,25,51,0.49,12,37,0.324,21,29,0.724,107
628,2021/1/26,NYK,UTA,L 94-108,240,36,83,0.434,26,56,0.464,10,27,0.37,12,17,0.706,94,37,92,0.402,22,44,0.5,15,48,0.313,19,22,0.864,108
629,2021/1/26,UTA,NYK,W 108-94,240,37,92,0.402,22,44,0.5,15,48,0.313,19,22,0.864,108,36,83,0.434,26,56,0.464,10,27,0.37,12,17,0.706,94
630,2021/1/25,BRK,MIA,W 98-85,240,34,85,0.4,23,47,0.489,11,38,0.289,19,22,0.864,98,31,84,0.369,20,41,0.488,11,43,0.256,12,17,0.706,85
631,2021/1/25,MIA,BRK,L 85-98,240,31,84,0.369,20,41,0.488,11,43,0.256,12,17,0.706,85,34,85,0.4,23,47,0.489,11,38,0.289,19,22,0.864,98
632,2021/1/25,BOS,CHI,W 119-103,240,44,87,0.506,29,58,0.5,15,29,0.517,16,20,0.8,119,41,88,0.466,24,49,0.49,17,39,0.436,4,10,0.4,103
633,2021/1/25,CHI,BOS,L 103-119,240,41,88,0.466,24,49,0.49,17,39,0.436,4,10,0.4,103,44,87,0.506,29,58,0.5,15,29,0.517,16,20,0.8,119
634,2021/1/25,CLE,LAL,L 108-115,240,40,86,0.465,31,65,0.477,9,21,0.429,19,22,0.864,108,42,87,0.483,32,55,0.582,10,32,0.313,21,28,0.75,115
635,2021/1/25,LAL,CLE,W 115-108,240,42,87,0.483,32,55,0.582,10,32,0.313,21,28,0.75,115,40,86,0.465,31,65,0.477,9,21,0.429,19,22,0.864,108
636,2021/1/25,DAL,DEN,L 113-117,240,41,84,0.488,30,52,0.577,11,32,0.344,20,24,0.833,113,40,79,0.506,25,44,0.568,15,35,0.429,22,28,0.786,117
637,2021/1/25,DEN,DAL,W 117-113,240,40,79,0.506,25,44,0.568,15,35,0.429,22,28,0.786,117,41,84,0.488,30,52,0.577,11,32,0.344,20,24,0.833,113
638,2021/1/25,DET,PHI,W 119-104,240,35,70,0.5,18,32,0.563,17,38,0.447,32,38,0.842,119,40,94,0.426,31,66,0.47,9,28,0.321,15,20,0.75,104
639,2021/1/25,PHI,DET,L 104-119,240,40,94,0.426,31,66,0.47,9,28,0.321,15,20,0.75,104,35,70,0.5,18,32,0.563,17,38,0.447,32,38,0.842,119
640,2021/1/25,GSW,MIN,W 130-108,240,44,89,0.494,30,59,0.508,14,30,0.467,28,37,0.757,130,39,94,0.415,31,70,0.443,8,24,0.333,22,25,0.88,108
641,2021/1/25,MIN,GSW,L 108-130,240,39,94,0.415,31,70,0.443,8,24,0.333,22,25,0.88,108,44,89,0.494,30,59,0.508,14,30,0.467,28,37,0.757,130
642,2021/1/25,IND,TOR,W 129-114,240,40,78,0.513,28,49,0.571,12,29,0.414,37,45,0.822,129,38,93,0.409,24,55,0.436,14,38,0.368,24,27,0.889,114
643,2021/1/25,TOR,IND,L 114-129,240,38,93,0.409,24,55,0.436,14,38,0.368,24,27,0.889,114,40,78,0.513,28,49,0.571,12,29,0.414,37,45,0.822,129
644,2021/1/25,CHO,ORL,L 108-117,240,39,89,0.438,28,51,0.549,11,38,0.289,19,27,0.704,108,42,88,0.477,23,51,0.451,19,37,0.514,14,22,0.636,117
645,2021/1/25,ORL,CHO,W 117-108,240,42,88,0.477,23,51,0.451,19,37,0.514,14,22,0.636,117,39,89,0.438,28,51,0.549,11,38,0.289,19,27,0.704,108
646,2021/1/25,OKC,POR,W 125-122,240,43,84,0.512,25,44,0.568,18,40,0.45,21,35,0.6,125,46,98,0.469,32,57,0.561,14,41,0.341,16,21,0.762,122
647,2021/1/25,POR,OKC,L 122-125,240,46,98,0.469,32,57,0.561,14,41,0.341,16,21,0.762,122,43,84,0.512,25,44,0.568,18,40,0.45,21,35,0.6,125
648,2021/1/24,BOS,CLE,W 141-103,240,52,93,0.559,38,65,0.585,14,28,0.5,23,27,0.852,141,34,85,0.4,24,52,0.462,10,33,0.303,25,34,0.735,103
649,2021/1/24,CLE,BOS,L 103-141,240,34,85,0.4,24,52,0.462,10,33,0.303,25,34,0.735,103,52,93,0.559,38,65,0.585,14,28,0.5,23,27,0.852,141
650,2021/1/24,IND,TOR,L 102-107,240,35,87,0.402,22,48,0.458,13,39,0.333,19,22,0.864,102,37,90,0.411,22,55,0.4,15,35,0.429,18,26,0.692,107
651,2021/1/24,TOR,IND,W 107-102,240,37,90,0.411,22,55,0.4,15,35,0.429,18,26,0.692,107,35,87,0.402,22,48,0.458,13,39,0.333,19,22,0.864,102
652,2021/1/24,LAC,OKC,W 108-100,240,41,92,0.446,27,46,0.587,14,46,0.304,12,16,0.75,108,42,95,0.442,35,60,0.583,7,35,0.2,9,14,0.643,100
653,2021/1/24,OKC,LAC,L 100-108,240,42,95,0.442,35,60,0.583,7,35,0.2,9,14,0.643,100,41,92,0.446,27,46,0.587,14,46,0.304,12,16,0.75,108
654,2021/1/24,ATL,MIL,L 115-129,240,42,83,0.506,28,44,0.636,14,39,0.359,17,22,0.773,115,50,91,0.549,40,60,0.667,10,31,0.323,19,27,0.704,129
655,2021/1/24,MIL,ATL,W 129-115,240,50,91,0.549,40,60,0.667,10,31,0.323,19,27,0.704,129,42,83,0.506,28,44,0.636,14,39,0.359,17,22,0.773,115
656,2021/1/24,CHO,ORL,W 107-104,240,42,88,0.477,28,52,0.538,14,36,0.389,9,16,0.563,107,39,87,0.448,22,49,0.449,17,38,0.447,9,13,0.692,104
657,2021/1/24,ORL,CHO,L 104-107,240,39,87,0.448,22,49,0.449,17,38,0.447,9,13,0.692,104,42,88,0.477,28,52,0.538,14,36,0.389,9,16,0.563,107
658,2021/1/24,NYK,POR,L 113-116,240,39,86,0.453,27,57,0.474,12,29,0.414,23,25,0.92,113,39,83,0.47,22,37,0.595,17,46,0.37,21,23,0.913,116
659,2021/1/24,POR,NYK,W 116-113,240,39,83,0.47,22,37,0.595,17,46,0.37,21,23,0.913,116,39,86,0.453,27,57,0.474,12,29,0.414,23,25,0.92,113
660,2021/1/24,SAS,WAS,W 121-101,240,48,96,0.5,33,65,0.508,15,31,0.484,10,11,0.909,121,39,92,0.424,25,50,0.5,14,42,0.333,9,14,0.643,101
661,2021/1/24,WAS,SAS,L 101-121,240,39,92,0.424,25,50,0.5,14,42,0.333,9,14,0.643,101,48,96,0.5,33,65,0.508,15,31,0.484,10,11,0.909,121
662,2021/1/23,BRK,MIA,W 128-124,240,44,83,0.53,25,46,0.543,19,37,0.514,21,26,0.808,128,42,89,0.472,29,43,0.674,13,46,0.283,27,32,0.844,124
663,2021/1/23,MIA,BRK,L 124-128,240,42,89,0.472,29,43,0.674,13,46,0.283,27,32,0.844,124,44,83,0.53,25,46,0.543,19,37,0.514,21,26,0.808,128
664,2021/1/23,CHI,LAL,L 90-101,240,33,84,0.393,25,59,0.424,8,25,0.32,16,22,0.727,90,36,79,0.456,32,60,0.533,4,19,0.211,25,31,0.806,101
665,2021/1/23,LAL,CHI,W 101-90,240,36,79,0.456,32,60,0.533,4,19,0.211,25,31,0.806,101,33,84,0.393,25,59,0.424,8,25,0.32,16,22,0.727,90
666,2021/1/23,DAL,HOU,L 108-133,240,37,83,0.446,32,58,0.552,5,25,0.2,29,40,0.725,108,47,86,0.547,31,49,0.633,16,37,0.432,23,29,0.793,133
667,2021/1/23,HOU,DAL,W 133-108,240,47,86,0.547,31,49,0.633,16,37,0.432,23,29,0.793,133,37,83,0.446,32,58,0.552,5,25,0.2,29,40,0.725,108
668,2021/1/23,DET,PHI,L 110-114,240,37,86,0.43,23,53,0.434,14,33,0.424,22,30,0.733,110,38,83,0.458,30,60,0.5,8,23,0.348,30,38,0.789,114
669,2021/1/23,PHI,DET,W 114-110,240,38,83,0.458,30,60,0.5,8,23,0.348,30,38,0.789,114,37,86,0.43,23,53,0.434,14,33,0.424,22,30,0.733,110
670,2021/1/23,MIN,NOP,W 120-110,240,39,91,0.429,27,57,0.474,12,34,0.353,30,37,0.811,120,40,87,0.46,30,54,0.556,10,33,0.303,20,28,0.714,110
671,2021/1/23,NOP,MIN,L 110-120,240,40,87,0.46,30,54,0.556,10,33,0.303,20,28,0.714,110,39,91,0.429,27,57,0.474,12,34,0.353,30,37,0.811,120
672,2021/1/23,DEN,PHO,W 120-112 (2OT),290,40,97,0.412,25,61,0.41,15,36,0.417,25,32,0.781,120,41,102,0.402,25,49,0.51,16,53,0.302,14,18,0.778,112
673,2021/1/23,PHO,DEN,L 112-120 (2OT),290,41,102,0.402,25,49,0.51,16,53,0.302,14,18,0.778,112,40,97,0.412,25,61,0.41,15,36,0.417,25,32,0.781,120
674,2021/1/23,GSW,UTA,L 108-127,240,42,93,0.452,28,54,0.519,14,39,0.359,10,15,0.667,108,45,94,0.479,25,44,0.568,20,50,0.4,17,22,0.773,127
675,2021/1/23,UTA,GSW,W 127-108,240,45,94,0.479,25,44,0.568,20,50,0.4,17,22,0.773,127,42,93,0.452,28,54,0.519,14,39,0.359,10,15,0.667,108
676,2021/1/22,CHI,CHO,W 123-110,240,49,96,0.51,34,53,0.642,15,43,0.349,10,12,0.833,123,42,85,0.494,35,53,0.66,7,32,0.219,19,25,0.76,110
677,2021/1/22,CHO,CHI,L 110-123,240,42,85,0.494,35,53,0.66,7,32,0.219,19,25,0.76,110,49,96,0.51,34,53,0.642,15,43,0.349,10,12,0.833,123
678,2021/1/22,BRK,CLE,L 113-125,240,42,87,0.483,28,44,0.636,14,43,0.326,15,17,0.882,113,45,87,0.517,37,62,0.597,8,25,0.32,27,32,0.844,125
679,2021/1/22,CLE,BRK,W 125-113,240,45,87,0.517,37,62,0.597,8,25,0.32,27,32,0.844,125,42,87,0.483,28,44,0.636,14,43,0.326,15,17,0.882,113
680,2021/1/22,DET,HOU,L 102-103,240,31,82,0.378,16,50,0.32,15,32,0.469,25,37,0.676,102,37,95,0.389,23,54,0.426,14,41,0.341,15,20,0.75,103
681,2021/1/22,HOU,DET,W 103-102,240,37,95,0.389,23,54,0.426,14,41,0.341,15,20,0.75,103,31,82,0.378,16,50,0.32,15,32,0.469,25,37,0.676,102
682,2021/1/22,IND,ORL,W 120-118 (OT),265,46,93,0.495,34,59,0.576,12,34,0.353,16,18,0.889,120,43,94,0.457,26,57,0.456,17,37,0.459,15,24,0.625,118
683,2021/1/22,ORL,IND,L 118-120 (OT),265,43,94,0.457,26,57,0.456,17,37,0.459,15,24,0.625,118,46,93,0.495,34,59,0.576,12,34,0.353,16,18,0.889,120
684,2021/1/22,LAC,OKC,W 120-106,240,43,84,0.512,33,51,0.647,10,33,0.303,24,25,0.96,120,41,87,0.471,27,45,0.6,14,42,0.333,10,13,0.769,106
685,2021/1/22,OKC,LAC,L 106-120,240,41,87,0.471,27,45,0.6,14,42,0.333,10,13,0.769,106,43,84,0.512,33,51,0.647,10,33,0.303,24,25,0.96,120
686,2021/1/22,ATL,MIN,W 116-98,240,38,83,0.458,23,48,0.479,15,35,0.429,25,30,0.833,116,40,93,0.43,32,61,0.525,8,32,0.25,10,12,0.833,98
687,2021/1/22,MIN,ATL,L 98-116,240,40,93,0.43,32,61,0.525,8,32,0.25,10,12,0.833,98,38,83,0.458,23,48,0.479,15,35,0.429,25,30,0.833,116
688,2021/1/22,BOS,PHI,L 110-122,240,41,90,0.456,29,60,0.483,12,30,0.4,16,20,0.8,110,45,81,0.556,33,53,0.623,12,28,0.429,20,24,0.833,122
689,2021/1/22,PHI,BOS,W 122-110,240,45,81,0.556,33,53,0.623,12,28,0.429,20,24,0.833,122,41,90,0.456,29,60,0.483,12,30,0.4,16,20,0.8,110
690,2021/1/22,DEN,PHO,W 130-126 (OT),265,53,103,0.515,47,77,0.61,6,26,0.231,18,19,0.947,130,47,94,0.5,30,50,0.6,17,44,0.386,15,15,1,126
691,2021/1/22,PHO,DEN,L 126-130 (OT),265,47,94,0.5,30,50,0.6,17,44,0.386,15,15,1,126,53,103,0.515,47,77,0.61,6,26,0.231,18,19,0.947,130
692,2021/1/22,NYK,SAC,L 94-103,240,36,94,0.383,31,72,0.431,5,22,0.227,17,25,0.68,94,38,91,0.418,26,57,0.456,12,34,0.353,15,21,0.714,103
693,2021/1/22,SAC,NYK,W 103-94,240,38,91,0.418,26,57,0.456,12,34,0.353,15,21,0.714,103,36,94,0.383,31,72,0.431,5,22,0.227,17,25,0.68,94
694,2021/1/22,DAL,SAS,W 122-117,240,45,93,0.484,31,54,0.574,14,39,0.359,18,20,0.9,122,41,89,0.461,29,61,0.475,12,28,0.429,23,30,0.767,117
695,2021/1/22,SAS,DAL,L 117-122,240,41,89,0.461,29,61,0.475,12,28,0.429,23,30,0.767,117,45,93,0.484,31,54,0.574,14,39,0.359,18,20,0.9,122
696,2021/1/22,MIA,TOR,L 81-101,240,33,77,0.429,26,46,0.565,7,31,0.226,8,10,0.8,81,39,84,0.464,22,44,0.5,17,40,0.425,6,9,0.667,101
697,2021/1/22,TOR,MIA,W 101-81,240,39,84,0.464,22,44,0.5,17,40,0.425,6,9,0.667,101,33,77,0.429,26,46,0.565,7,31,0.226,8,10,0.8,81
698,2021/1/21,GSW,NYK,L 104-119,240,33,86,0.384,24,48,0.5,9,38,0.237,29,39,0.744,104,38,82,0.463,27,58,0.466,11,24,0.458,32,41,0.78,119
699,2021/1/21,NYK,GSW,W 119-104,240,38,82,0.463,27,58,0.466,11,24,0.458,32,41,0.78,119,33,86,0.384,24,48,0.5,9,38,0.237,29,39,0.744,104
700,2021/1/21,LAL,MIL,W 113-106,240,41,88,0.466,22,51,0.431,19,37,0.514,12,15,0.8,113,44,87,0.506,35,59,0.593,9,28,0.321,9,12,0.75,106
701,2021/1/21,MIL,LAL,L 106-113,240,44,87,0.506,35,59,0.593,9,28,0.321,9,12,0.75,106,41,88,0.466,22,51,0.431,19,37,0.514,12,15,0.8,113
702,2021/1/21,NOP,UTA,L 118-129,240,42,85,0.494,31,60,0.517,11,25,0.44,23,30,0.767,118,44,88,0.5,27,49,0.551,17,39,0.436,24,25,0.96,129
703,2021/1/21,UTA,NOP,W 129-118,240,44,88,0.5,27,49,0.551,17,39,0.436,24,25,0.96,129,42,85,0.494,31,60,0.517,11,25,0.44,23,30,0.767,118
704,2021/1/20,ATL,DET,W 123-115 (OT),265,44,100,0.44,35,77,0.455,9,23,0.391,26,38,0.684,123,44,97,0.454,34,66,0.515,10,31,0.323,17,19,0.895,115
705,2021/1/20,DET,ATL,L 115-123 (OT),265,44,97,0.454,34,66,0.515,10,31,0.323,17,19,0.895,115,44,100,0.44,35,77,0.455,9,23,0.391,26,38,0.684,123
706,2021/1/20,BRK,CLE,L 135-147 (2OT),290,48,106,0.453,33,65,0.508,15,41,0.366,24,27,0.889,135,56,109,0.514,36,69,0.522,20,40,0.5,15,21,0.714,147
707,2021/1/20,CLE,BRK,W 147-135 (2OT),290,56,109,0.514,36,69,0.522,20,40,0.5,15,21,0.714,147,48,106,0.453,33,65,0.508,15,41,0.366,24,27,0.889,135
708,2021/1/20,GSW,SAS,W 121-99,240,46,91,0.505,31,53,0.585,15,38,0.395,14,20,0.7,121,35,94,0.372,31,61,0.508,4,33,0.121,25,31,0.806,99
709,2021/1/20,SAS,GSW,L 99-121,240,35,94,0.372,31,61,0.508,4,33,0.121,25,31,0.806,99,46,91,0.505,31,53,0.585,15,38,0.395,14,20,0.7,121
710,2021/1/20,HOU,PHO,L 103-109,240,37,88,0.42,27,57,0.474,10,31,0.323,19,22,0.864,103,42,89,0.472,34,55,0.618,8,34,0.235,17,19,0.895,109
711,2021/1/20,PHO,HOU,W 109-103,240,42,89,0.472,34,55,0.618,8,34,0.235,17,19,0.895,109,37,88,0.42,27,57,0.474,10,31,0.323,19,22,0.864,103
712,2021/1/20,DAL,IND,W 124-112,240,51,97,0.526,43,70,0.614,8,27,0.296,14,17,0.824,124,41,92,0.446,25,53,0.472,16,39,0.41,14,21,0.667,112
713,2021/1/20,IND,DAL,L 112-124,240,41,92,0.446,25,53,0.472,16,39,0.41,14,21,0.667,112,51,97,0.526,43,70,0.614,8,27,0.296,14,17,0.824,124
714,2021/1/20,LAC,SAC,W 115-96,240,41,86,0.477,25,51,0.49,16,35,0.457,17,18,0.944,115,39,86,0.453,26,58,0.448,13,28,0.464,5,12,0.417,96
715,2021/1/20,SAC,LAC,L 96-115,240,39,86,0.453,26,58,0.448,13,28,0.464,5,12,0.417,96,41,86,0.477,25,51,0.49,16,35,0.457,17,18,0.944,115
716,2021/1/20,MIN,ORL,L 96-97,240,36,85,0.424,21,50,0.42,15,35,0.429,9,14,0.643,96,36,92,0.391,26,61,0.426,10,31,0.323,15,21,0.714,97
717,2021/1/20,ORL,MIN,W 97-96,240,36,92,0.391,26,61,0.426,10,31,0.323,15,21,0.714,97,36,85,0.424,21,50,0.42,15,35,0.429,9,14,0.643,96
718,2021/1/20,BOS,PHI,L 109-117,240,42,89,0.472,30,56,0.536,12,33,0.364,13,20,0.65,109,36,78,0.462,27,51,0.529,9,27,0.333,36,45,0.8,117
719,2021/1/20,PHI,BOS,W 117-109,240,36,78,0.462,27,51,0.529,9,27,0.333,36,45,0.8,117,42,89,0.472,30,56,0.536,12,33,0.364,13,20,0.65,109
720,2021/1/20,MIA,TOR,W 111-102,240,39,80,0.488,21,40,0.525,18,40,0.45,15,17,0.882,111,35,88,0.398,19,39,0.487,16,49,0.327,16,18,0.889,102
721,2021/1/20,TOR,MIA,L 102-111,240,35,88,0.398,19,39,0.487,16,49,0.327,16,18,0.889,102,39,80,0.488,21,40,0.525,18,40,0.45,15,17,0.882,111
722,2021/1/19,DEN,OKC,W 119-101,240,46,105,0.438,32,63,0.508,14,42,0.333,13,14,0.929,119,36,86,0.419,22,43,0.512,14,43,0.326,15,23,0.652,101
723,2021/1/19,OKC,DEN,L 101-119,240,36,86,0.419,22,43,0.512,14,43,0.326,15,23,0.652,101,46,105,0.438,32,63,0.508,14,42,0.333,13,14,0.929,119
724,2021/1/19,NOP,UTA,L 102-118,240,43,95,0.453,37,69,0.536,6,26,0.231,10,15,0.667,102,43,85,0.506,22,38,0.579,21,47,0.447,11,17,0.647,118
725,2021/1/19,UTA,NOP,W 118-102,240,43,85,0.506,22,38,0.579,21,47,0.447,11,17,0.647,118,43,95,0.453,37,69,0.536,6,26,0.231,10,15,0.667,102
726,2021/1/18,ATL,MIN,W 108-97,240,37,79,0.468,26,51,0.51,11,28,0.393,23,25,0.92,108,36,91,0.396,22,54,0.407,14,37,0.378,11,16,0.688,97
727,2021/1/18,MIN,ATL,L 97-108,240,36,91,0.396,22,54,0.407,14,37,0.378,11,16,0.688,97,37,79,0.468,26,51,0.51,11,28,0.393,23,25,0.92,108
728,2021/1/18,BRK,MIL,W 125-123,240,46,84,0.548,31,53,0.585,15,31,0.484,18,21,0.857,125,46,105,0.438,35,67,0.522,11,38,0.289,20,24,0.833,123
729,2021/1/18,MIL,BRK,L 123-125,240,46,105,0.438,35,67,0.522,11,38,0.289,20,24,0.833,123,46,84,0.548,31,53,0.585,15,31,0.484,18,21,0.857,125
730,2021/1/18,CHI,HOU,W 125-120,240,43,92,0.467,23,47,0.489,20,45,0.444,19,21,0.905,125,46,88,0.523,29,48,0.604,17,40,0.425,11,17,0.647,120
731,2021/1/18,HOU,CHI,L 120-125,240,46,88,0.523,29,48,0.604,17,40,0.425,11,17,0.647,120,43,92,0.467,23,47,0.489,20,45,0.444,19,21,0.905,125
732,2021/1/18,GSW,LAL,W 115-113,240,44,87,0.506,32,50,0.64,12,37,0.324,15,20,0.75,115,40,83,0.482,31,54,0.574,9,29,0.31,24,33,0.727,113
733,2021/1/18,LAL,GSW,L 113-115,240,40,83,0.482,31,54,0.574,9,29,0.31,24,33,0.727,113,44,87,0.506,32,50,0.64,12,37,0.324,15,20,0.75,115
734,2021/1/18,MEM,PHO,W 108-104,240,41,83,0.494,30,57,0.526,11,26,0.423,15,20,0.75,108,40,88,0.455,25,52,0.481,15,36,0.417,9,16,0.563,104
735,2021/1/18,PHO,MEM,L 104-108,240,40,88,0.455,25,52,0.481,15,36,0.417,9,16,0.563,104,41,83,0.494,30,57,0.526,11,26,0.423,15,20,0.75,108
736,2021/1/18,DET,MIA,L 107-113,240,38,82,0.463,25,45,0.556,13,37,0.351,18,24,0.75,107,43,75,0.573,31,45,0.689,12,30,0.4,15,19,0.789,113
737,2021/1/18,MIA,DET,W 113-107,240,43,75,0.573,31,45,0.689,12,30,0.4,15,19,0.789,113,38,82,0.463,25,45,0.556,13,37,0.351,18,24,0.75,107
738,2021/1/18,NYK,ORL,W 91-84,240,31,87,0.356,26,60,0.433,5,27,0.185,24,34,0.706,91,29,86,0.337,17,48,0.354,12,38,0.316,14,16,0.875,84
739,2021/1/18,ORL,NYK,L 84-91,240,29,86,0.337,17,48,0.354,12,38,0.316,14,16,0.875,84,31,87,0.356,26,60,0.433,5,27,0.185,24,34,0.706,91
740,2021/1/18,POR,SAS,L 104-125,240,39,90,0.433,29,55,0.527,10,35,0.286,16,19,0.842,104,48,90,0.533,33,57,0.579,15,33,0.455,14,16,0.875,125
741,2021/1/18,SAS,POR,W 125-104,240,48,90,0.533,33,57,0.579,15,33,0.455,14,16,0.875,125,39,90,0.433,29,55,0.527,10,35,0.286,16,19,0.842,104
742,2021/1/18,DAL,TOR,L 93-116,240,31,82,0.378,22,46,0.478,9,36,0.25,22,27,0.815,93,44,88,0.5,32,55,0.582,12,33,0.364,16,18,0.889,116
743,2021/1/18,TOR,DAL,W 116-93,240,44,88,0.5,32,55,0.582,12,33,0.364,16,18,0.889,116,31,82,0.378,22,46,0.478,9,36,0.25,22,27,0.815,93
744,2021/1/17,BOS,NYK,L 75-105,240,25,84,0.298,18,38,0.474,7,46,0.152,18,29,0.621,75,38,80,0.475,26,49,0.531,12,31,0.387,17,21,0.81,105
745,2021/1/17,NYK,BOS,W 105-75,240,38,80,0.475,26,49,0.531,12,31,0.387,17,21,0.81,105,25,84,0.298,18,38,0.474,7,46,0.152,18,29,0.621,75
746,2021/1/17,CHI,DAL,W 117-101,240,43,85,0.506,36,60,0.6,7,25,0.28,24,33,0.727,117,41,93,0.441,33,62,0.532,8,31,0.258,11,19,0.579,101
747,2021/1/17,DAL,CHI,L 101-117,240,41,93,0.441,33,62,0.532,8,31,0.258,11,19,0.579,101,43,85,0.506,36,60,0.6,7,25,0.28,24,33,0.727,117
748,2021/1/17,DEN,UTA,L 105-109,240,40,100,0.4,26,63,0.413,14,37,0.378,11,15,0.733,105,39,76,0.513,24,39,0.615,15,37,0.405,16,28,0.571,109
749,2021/1/17,UTA,DEN,W 109-105,240,39,76,0.513,24,39,0.615,15,37,0.405,16,28,0.571,109,40,100,0.4,26,63,0.413,14,37,0.378,11,15,0.733,105
750,2021/1/17,IND,LAC,L 96-129,240,37,89,0.416,26,51,0.51,11,38,0.289,11,16,0.688,96,48,87,0.552,29,48,0.604,19,39,0.487,14,20,0.7,129
751,2021/1/17,LAC,IND,W 129-96,240,48,87,0.552,29,48,0.604,19,39,0.487,14,20,0.7,129,37,89,0.416,26,51,0.51,11,38,0.289,11,16,0.688,96
752,2021/1/17,NOP,SAC,W 128-123,240,45,85,0.529,34,63,0.54,11,22,0.5,27,34,0.794,128,47,91,0.516,34,52,0.654,13,39,0.333,16,18,0.889,123
753,2021/1/17,SAC,NOP,L 123-128,240,47,91,0.516,34,52,0.654,13,39,0.333,16,18,0.889,123,45,85,0.529,34,63,0.54,11,22,0.5,27,34,0.794,128
754,2021/1/16,BRK,ORL,W 122-115,240,42,78,0.538,26,43,0.605,16,35,0.457,22,25,0.88,122,44,95,0.463,30,49,0.612,14,46,0.304,13,16,0.813,115
755,2021/1/16,ORL,BRK,L 115-122,240,44,95,0.463,30,49,0.612,14,46,0.304,13,16,0.813,115,42,78,0.538,26,43,0.605,16,35,0.457,22,25,0.88,122
756,2021/1/16,MEM,PHI,W 106-104,240,43,99,0.434,35,70,0.5,8,29,0.276,12,18,0.667,106,37,84,0.44,30,59,0.508,7,25,0.28,23,32,0.719,104
757,2021/1/16,PHI,MEM,L 104-106,240,37,84,0.44,30,59,0.508,7,25,0.28,23,32,0.719,104,43,99,0.434,35,70,0.5,8,29,0.276,12,18,0.667,106
758,2021/1/16,DET,MIA,W 120-100,240,46,91,0.505,28,45,0.622,18,46,0.391,10,15,0.667,120,32,67,0.478,20,38,0.526,12,29,0.414,24,27,0.889,100
759,2021/1/16,MIA,DET,L 100-120,240,32,67,0.478,20,38,0.526,12,29,0.414,24,27,0.889,100,46,91,0.505,28,45,0.622,18,46,0.391,10,15,0.667,120
760,2021/1/16,ATL,POR,L 106-112,240,38,87,0.437,32,57,0.561,6,30,0.2,24,28,0.857,106,40,103,0.388,25,59,0.424,15,44,0.341,17,20,0.85,112
761,2021/1/16,POR,ATL,W 112-106,240,40,103,0.388,25,59,0.424,15,44,0.341,17,20,0.85,112,38,87,0.437,32,57,0.561,6,30,0.2,24,28,0.857,106
762,2021/1/16,HOU,SAS,L 91-103,240,31,84,0.369,19,52,0.365,12,32,0.375,17,27,0.63,91,40,100,0.4,35,76,0.461,5,24,0.208,18,23,0.783,103
763,2021/1/16,SAS,HOU,W 103-91,240,40,100,0.4,35,76,0.461,5,24,0.208,18,23,0.783,103,31,84,0.369,19,52,0.365,12,32,0.375,17,27,0.63,91
764,2021/1/16,CHO,TOR,L 113-116,240,38,87,0.437,23,51,0.451,15,36,0.417,22,29,0.759,113,36,86,0.419,15,37,0.405,21,49,0.429,23,26,0.885,116
765,2021/1/16,TOR,CHO,W 116-113,240,36,86,0.419,15,37,0.405,21,49,0.429,23,26,0.885,116,38,87,0.437,23,51,0.451,15,36,0.417,22,29,0.759,113
766,2021/1/15,BOS,ORL,W 124-97,240,45,88,0.511,28,46,0.609,17,42,0.405,17,19,0.895,124,38,94,0.404,31,66,0.47,7,28,0.25,14,22,0.636,97
767,2021/1/15,ORL,BOS,L 97-124,240,38,94,0.404,31,66,0.47,7,28,0.25,14,22,0.636,97,45,88,0.511,28,46,0.609,17,42,0.405,17,19,0.895,124
768,2021/1/15,CLE,NYK,W 106-103,240,36,79,0.456,27,52,0.519,9,27,0.333,25,34,0.735,106,40,82,0.488,31,57,0.544,9,25,0.36,14,16,0.875,103
769,2021/1/15,NYK,CLE,L 103-106,240,40,82,0.488,31,57,0.544,9,25,0.36,14,16,0.875,103,36,79,0.456,27,52,0.519,9,27,0.333,25,34,0.735,106
770,2021/1/15,LAL,NOP,W 112-95,240,39,93,0.419,24,56,0.429,15,37,0.405,19,26,0.731,112,41,86,0.477,32,57,0.561,9,29,0.31,4,8,0.5,95
771,2021/1/15,NOP,LAL,L 95-112,240,41,86,0.477,32,57,0.561,9,29,0.31,4,8,0.5,95,39,93,0.419,24,56,0.429,15,37,0.405,19,26,0.731,112
772,2021/1/15,DAL,MIL,L 109-112,240,45,97,0.464,32,61,0.525,13,36,0.361,6,13,0.462,109,43,96,0.448,29,59,0.492,14,37,0.378,12,25,0.48,112
773,2021/1/15,MIL,DAL,W 112-109,240,43,96,0.448,29,59,0.492,14,37,0.378,12,25,0.48,112,45,97,0.464,32,61,0.525,13,36,0.361,6,13,0.462,109
774,2021/1/15,CHI,OKC,L 125-127 (OT),265,43,91,0.473,22,45,0.489,21,46,0.457,18,25,0.72,125,48,105,0.457,33,60,0.55,15,45,0.333,16,24,0.667,127
775,2021/1/15,OKC,CHI,W 127-125 (OT),265,48,105,0.457,33,60,0.55,15,45,0.333,16,24,0.667,127,43,91,0.473,22,45,0.489,21,46,0.457,18,25,0.72,125
776,2021/1/15,LAC,SAC,W 138-100,240,52,89,0.584,34,54,0.63,18,35,0.514,16,20,0.8,138,40,85,0.471,32,59,0.542,8,26,0.308,12,17,0.706,100
777,2021/1/15,SAC,LAC,L 100-138,240,40,85,0.471,32,59,0.542,8,26,0.308,12,17,0.706,100,52,89,0.584,34,54,0.63,18,35,0.514,16,20,0.8,138
778,2021/1/15,ATL,UTA,L 92-116,240,38,92,0.413,33,64,0.516,5,28,0.179,11,15,0.733,92,43,92,0.467,23,48,0.479,20,44,0.455,10,14,0.714,116
779,2021/1/15,UTA,ATL,W 116-92,240,43,92,0.467,23,48,0.479,20,44,0.455,10,14,0.714,116,38,92,0.413,33,64,0.516,5,28,0.179,11,15,0.733,92
780,2021/1/14,DEN,GSW,W 114-104,240,41,90,0.456,30,53,0.566,11,37,0.297,21,27,0.778,114,38,81,0.469,27,52,0.519,11,29,0.379,17,24,0.708,104
781,2021/1/14,GSW,DEN,L 104-114,240,38,81,0.469,27,52,0.519,11,29,0.379,17,24,0.708,104,41,90,0.456,30,53,0.566,11,37,0.297,21,27,0.778,114
782,2021/1/14,MIA,PHI,L 108-125,240,40,81,0.494,28,47,0.596,12,34,0.353,16,26,0.615,108,44,82,0.537,27,45,0.6,17,37,0.459,20,24,0.833,125
783,2021/1/14,PHI,MIA,W 125-108,240,44,82,0.537,27,45,0.6,17,37,0.459,20,24,0.833,125,40,81,0.494,28,47,0.596,12,34,0.353,16,26,0.615,108
784,2021/1/14,IND,POR,W 111-87,240,44,92,0.478,35,62,0.565,9,30,0.3,14,18,0.778,111,32,87,0.368,19,44,0.432,13,43,0.302,10,10,1,87
785,2021/1/14,POR,IND,L 87-111,240,32,87,0.368,19,44,0.432,13,43,0.302,10,10,1,87,44,92,0.478,35,62,0.565,9,30,0.3,14,18,0.778,111
786,2021/1/14,HOU,SAS,W 109-105,240,42,86,0.488,29,53,0.547,13,33,0.394,12,19,0.632,109,42,92,0.457,33,61,0.541,9,31,0.29,12,16,0.75,105
787,2021/1/14,SAS,HOU,L 105-109,240,42,92,0.457,33,61,0.541,9,31,0.29,12,16,0.75,105,42,86,0.488,29,53,0.547,13,33,0.394,12,19,0.632,109
788,2021/1/14,CHO,TOR,L 108-111,240,42,87,0.483,27,52,0.519,15,35,0.429,9,12,0.75,108,40,88,0.455,20,38,0.526,20,50,0.4,11,13,0.846,111
789,2021/1/14,TOR,CHO,W 111-108,240,40,88,0.455,20,38,0.526,20,50,0.4,11,13,0.846,111,42,87,0.483,27,52,0.519,15,35,0.429,9,12,0.75,108
790,2021/1/13,CHO,DAL,L 93-104,240,38,100,0.38,28,62,0.452,10,38,0.263,7,14,0.5,93,40,96,0.417,25,50,0.5,15,46,0.326,9,16,0.563,104
791,2021/1/13,DAL,CHO,W 104-93,240,40,96,0.417,25,50,0.5,15,46,0.326,9,16,0.563,104,38,100,0.38,28,62,0.452,10,38,0.263,7,14,0.5,93
792,2021/1/13,DET,MIL,L 101-110,240,36,92,0.391,22,57,0.386,14,35,0.4,15,22,0.682,101,41,85,0.482,22,42,0.524,19,43,0.442,9,14,0.643,110
793,2021/1/13,MIL,DET,W 110-101,240,41,85,0.482,22,42,0.524,19,43,0.442,9,14,0.643,110,36,92,0.391,22,57,0.386,14,35,0.4,15,22,0.682,101
794,2021/1/13,LAC,NOP,W 111-106,240,35,74,0.473,17,37,0.459,18,37,0.486,23,27,0.852,111,42,88,0.477,32,60,0.533,10,28,0.357,12,16,0.75,106
795,2021/1/13,NOP,LAC,L 106-111,240,42,88,0.477,32,60,0.533,10,28,0.357,12,16,0.75,106,35,74,0.473,17,37,0.459,18,37,0.486,23,27,0.852,111
796,2021/1/13,MEM,MIN,W 118-107,240,50,106,0.472,42,81,0.519,8,25,0.32,10,13,0.769,118,39,90,0.433,30,53,0.566,9,37,0.243,20,24,0.833,107
797,2021/1/13,MIN,MEM,L 107-118,240,39,90,0.433,30,53,0.566,9,37,0.243,20,24,0.833,107,50,106,0.472,42,81,0.519,8,25,0.32,10,13,0.769,118
798,2021/1/13,BRK,NYK,W 116-109,240,44,91,0.484,28,51,0.549,16,40,0.4,12,17,0.706,116,44,92,0.478,33,64,0.516,11,28,0.393,10,12,0.833,109
799,2021/1/13,NYK,BRK,L 109-116,240,44,92,0.478,33,64,0.516,11,28,0.393,10,12,0.833,109,44,91,0.484,28,51,0.549,16,40,0.4,12,17,0.706,116
800,2021/1/13,LAL,OKC,W 128-99,240,47,95,0.495,30,58,0.517,17,37,0.459,17,22,0.773,128,37,86,0.43,27,55,0.491,10,31,0.323,15,19,0.789,99
801,2021/1/13,OKC,LAL,L 99-128,240,37,86,0.43,27,55,0.491,10,31,0.323,15,19,0.789,99,47,95,0.495,30,58,0.517,17,37,0.459,17,22,0.773,128
802,2021/1/13,POR,SAC,W 132-126,240,44,90,0.489,21,42,0.5,23,48,0.479,21,27,0.778,132,44,84,0.524,25,46,0.543,19,38,0.5,19,26,0.731,126
803,2021/1/13,SAC,POR,L 126-132,240,44,84,0.524,25,46,0.543,19,38,0.5,19,26,0.731,126,44,90,0.489,21,42,0.5,23,48,0.479,21,27,0.778,132
804,2021/1/12,BRK,DEN,W 122-116,240,48,79,0.608,32,47,0.681,16,32,0.5,10,15,0.667,122,44,88,0.5,26,51,0.51,18,37,0.486,10,16,0.625,116
805,2021/1/12,DEN,BRK,L 116-122,240,44,88,0.5,26,51,0.51,18,37,0.486,10,16,0.625,116,48,79,0.608,32,47,0.681,16,32,0.5,10,15,0.667,122
806,2021/1/12,CLE,UTA,L 87-117,240,35,90,0.389,27,59,0.458,8,31,0.258,9,14,0.643,87,42,84,0.5,18,39,0.462,24,45,0.533,9,12,0.75,117
807,2021/1/12,UTA,CLE,W 117-87,240,42,84,0.5,18,39,0.462,24,45,0.533,9,12,0.75,117,35,90,0.389,27,59,0.458,8,31,0.258,9,14,0.643,87
808,2021/1/12,GSW,IND,L 95-104,240,34,89,0.382,21,51,0.412,13,38,0.342,14,22,0.636,95,39,88,0.443,30,60,0.5,9,28,0.321,17,25,0.68,104
809,2021/1/12,IND,GSW,W 104-95,240,39,88,0.443,30,60,0.5,9,28,0.321,17,25,0.68,104,34,89,0.382,21,51,0.412,13,38,0.342,14,22,0.636,95
810,2021/1/12,HOU,LAL,L 100-117,240,38,97,0.392,26,57,0.456,12,40,0.3,12,16,0.75,100,42,84,0.5,28,52,0.538,14,32,0.438,19,27,0.704,117
811,2021/1/12,LAL,HOU,W 117-100,240,42,84,0.5,28,52,0.538,14,32,0.438,19,27,0.704,117,38,97,0.392,26,57,0.456,12,40,0.3,12,16,0.75,100
812,2021/1/12,OKC,SAS,L 102-112,240,36,83,0.434,29,57,0.509,7,26,0.269,23,29,0.793,102,41,95,0.432,31,60,0.517,10,35,0.286,20,22,0.909,112
813,2021/1/12,SAS,OKC,W 112-102,240,41,95,0.432,31,60,0.517,10,35,0.286,20,22,0.909,112,36,83,0.434,29,57,0.509,7,26,0.269,23,29,0.793,102
814,2021/1/12,MIA,PHI,L 134-137 (OT),265,48,104,0.462,29,48,0.604,19,56,0.339,19,24,0.792,134,50,102,0.49,31,47,0.66,19,55,0.345,18,25,0.72,137
815,2021/1/12,PHI,MIA,W 137-134 (OT),265,50,102,0.49,31,47,0.66,19,55,0.345,18,25,0.72,137,48,104,0.462,29,48,0.604,19,56,0.339,19,24,0.792,134
816,2021/1/11,ATL,PHI,W 112-94,240,37,99,0.374,20,55,0.364,17,44,0.386,21,27,0.778,112,37,92,0.402,29,56,0.518,8,36,0.222,12,13,0.923,94
817,2021/1/11,PHI,ATL,L 94-112,240,37,92,0.402,29,56,0.518,8,36,0.222,12,13,0.923,94,37,99,0.374,20,55,0.364,17,44,0.386,21,27,0.778,112
818,2021/1/11,CHO,NYK,W 109-88,240,38,78,0.487,25,46,0.543,13,32,0.406,20,23,0.87,109,34,87,0.391,25,50,0.5,9,37,0.243,11,17,0.647,88
819,2021/1/11,NYK,CHO,L 88-109,240,34,87,0.391,25,50,0.5,9,37,0.243,11,17,0.647,88,38,78,0.487,25,46,0.543,13,32,0.406,20,23,0.87,109
820,2021/1/11,CLE,MEM,L 91-101,240,37,82,0.451,26,56,0.464,11,26,0.423,6,14,0.429,91,40,78,0.513,35,58,0.603,5,20,0.25,16,21,0.762,101
821,2021/1/11,MEM,CLE,W 101-91,240,40,78,0.513,35,58,0.603,5,20,0.25,16,21,0.762,101,37,82,0.451,26,56,0.464,11,26,0.423,6,14,0.429,91
822,2021/1/11,MIL,ORL,W 121-99,240,46,91,0.505,33,56,0.589,13,35,0.371,16,20,0.8,121,39,91,0.429,28,60,0.467,11,31,0.355,10,13,0.769,99
823,2021/1/11,ORL,MIL,L 99-121,240,39,91,0.429,28,60,0.467,11,31,0.355,10,13,0.769,99,46,91,0.505,33,56,0.589,13,35,0.371,16,20,0.8,121
824,2021/1/11,POR,TOR,W 112-111,240,38,83,0.458,24,41,0.585,14,42,0.333,22,25,0.88,112,40,89,0.449,21,42,0.5,19,47,0.404,12,12,1,111
825,2021/1/11,TOR,POR,L 111-112,240,40,89,0.449,21,42,0.5,19,47,0.404,12,12,1,111,38,83,0.458,24,41,0.585,14,42,0.333,22,25,0.88,112
826,2021/1/11,IND,SAC,L 122-127,240,47,97,0.485,34,58,0.586,13,39,0.333,15,18,0.833,122,47,84,0.56,32,52,0.615,15,32,0.469,18,23,0.783,127
827,2021/1/11,SAC,IND,W 127-122,240,47,84,0.56,32,52,0.615,15,32,0.469,18,23,0.783,127,47,97,0.485,34,58,0.586,13,39,0.333,15,18,0.833,122
828,2021/1/11,PHO,WAS,L 107-128,240,39,87,0.448,35,60,0.583,4,27,0.148,25,30,0.833,107,48,92,0.522,33,58,0.569,15,34,0.441,17,28,0.607,128
829,2021/1/11,WAS,PHO,W 128-107,240,48,92,0.522,33,58,0.569,15,34,0.441,17,28,0.607,128,39,87,0.448,35,60,0.583,4,27,0.148,25,30,0.833,107
830,2021/1/10,BRK,OKC,L 116-129,240,43,85,0.506,33,51,0.647,10,34,0.294,20,24,0.833,116,49,90,0.544,34,51,0.667,15,39,0.385,16,17,0.941,129
831,2021/1/10,OKC,BRK,W 129-116,240,49,90,0.544,34,51,0.667,15,39,0.385,16,17,0.941,129,43,85,0.506,33,51,0.647,10,34,0.294,20,24,0.833,116
832,2021/1/10,DET,UTA,L 86-96,240,29,87,0.333,19,45,0.422,10,42,0.238,18,21,0.857,86,35,82,0.427,24,47,0.511,11,35,0.314,15,22,0.682,96
833,2021/1/10,UTA,DET,W 96-86,240,35,82,0.427,24,47,0.511,11,35,0.314,15,22,0.682,96,29,87,0.333,19,45,0.422,10,42,0.238,18,21,0.857,86
834,2021/1/10,GSW,TOR,W 106-105,240,38,93,0.409,25,47,0.532,13,46,0.283,17,19,0.895,106,39,96,0.406,26,58,0.448,13,38,0.342,14,22,0.636,105
835,2021/1/10,TOR,GSW,L 105-106,240,39,96,0.406,26,58,0.448,13,38,0.342,14,22,0.636,105,38,93,0.409,25,47,0.532,13,46,0.283,17,19,0.895,106
836,2021/1/10,HOU,LAL,L 102-120,240,37,90,0.411,25,49,0.51,12,41,0.293,16,23,0.696,102,46,91,0.505,36,62,0.581,10,29,0.345,18,24,0.75,120
837,2021/1/10,LAL,HOU,W 120-102,240,46,91,0.505,36,62,0.581,10,29,0.345,18,24,0.75,120,37,90,0.411,25,49,0.51,12,41,0.293,16,23,0.696,102
838,2021/1/10,CHI,LAC,L 127-130,240,47,77,0.61,29,44,0.659,18,33,0.545,15,17,0.882,127,45,92,0.489,25,54,0.463,20,38,0.526,20,25,0.8,130
839,2021/1/10,LAC,CHI,W 130-127,240,45,92,0.489,25,54,0.463,20,38,0.526,20,25,0.8,130,47,77,0.61,29,44,0.659,18,33,0.545,15,17,0.882,127
840,2021/1/10,MIN,SAS,W 96-88,240,34,81,0.42,25,55,0.455,9,26,0.346,19,23,0.826,96,36,94,0.383,28,64,0.438,8,30,0.267,8,14,0.571,88
841,2021/1/10,SAS,MIN,L 88-96,240,36,94,0.383,28,64,0.438,8,30,0.267,8,14,0.571,88,34,81,0.42,25,55,0.455,9,26,0.346,19,23,0.826,96
842,2021/1/10,DEN,NYK,W 114-89,240,45,84,0.536,30,49,0.612,15,35,0.429,9,12,0.75,114,32,74,0.432,26,53,0.491,6,21,0.286,19,25,0.76,89
843,2021/1/10,NYK,DEN,L 89-114,240,32,74,0.432,26,53,0.491,6,21,0.286,19,25,0.76,89,45,84,0.536,30,49,0.612,15,35,0.429,9,12,0.75,114
844,2021/1/9,ATL,CHO,L 105-113,240,34,89,0.382,20,44,0.455,14,45,0.311,23,28,0.821,105,40,77,0.519,25,44,0.568,15,33,0.455,18,24,0.75,113
845,2021/1/9,CHO,ATL,W 113-105,240,40,77,0.519,25,44,0.568,15,33,0.455,18,24,0.75,113,34,89,0.382,20,44,0.455,14,45,0.311,23,28,0.821,105
846,2021/1/9,DAL,ORL,W 112-98,240,39,79,0.494,19,39,0.487,20,40,0.5,14,18,0.778,112,38,89,0.427,32,58,0.552,6,31,0.194,16,22,0.727,98
847,2021/1/9,ORL,DAL,L 98-112,240,38,89,0.427,32,58,0.552,6,31,0.194,16,22,0.727,98,39,79,0.494,19,39,0.487,20,40,0.5,14,18,0.778,112
848,2021/1/9,IND,PHO,L 117-125,240,44,92,0.478,32,63,0.508,12,29,0.414,17,24,0.708,117,46,94,0.489,30,53,0.566,16,41,0.39,17,17,1,125
849,2021/1/9,PHO,IND,W 125-117,240,46,94,0.489,30,53,0.566,16,41,0.39,17,17,1,125,44,92,0.478,32,63,0.508,12,29,0.414,17,24,0.708,117
850,2021/1/9,CLE,MIL,L 90-100,240,36,87,0.414,29,61,0.475,7,26,0.269,11,16,0.688,90,37,84,0.44,25,48,0.521,12,36,0.333,14,18,0.778,100
851,2021/1/9,MIL,CLE,W 100-90,240,37,84,0.44,25,48,0.521,12,36,0.333,14,18,0.778,100,36,87,0.414,29,61,0.475,7,26,0.269,11,16,0.688,90
852,2021/1/9,MIN,SAS,L 122-125 (OT),265,48,96,0.5,33,66,0.5,15,30,0.5,11,17,0.647,122,44,101,0.436,31,69,0.449,13,32,0.406,24,29,0.828,125
853,2021/1/9,SAS,MIN,W 125-122 (OT),265,44,101,0.436,31,69,0.449,13,32,0.406,24,29,0.828,125,48,96,0.5,33,66,0.5,15,30,0.5,11,17,0.647,122
854,2021/1/9,DEN,PHI,W 115-103,240,45,90,0.5,33,57,0.579,12,33,0.364,13,15,0.867,115,43,103,0.417,32,68,0.471,11,35,0.314,6,10,0.6,103
855,2021/1/9,PHI,DEN,L 103-115,240,43,103,0.417,32,68,0.471,11,35,0.314,6,10,0.6,103,45,90,0.5,33,57,0.579,12,33,0.364,13,15,0.867,115
856,2021/1/9,POR,SAC,W 125-99,240,44,100,0.44,27,59,0.458,17,41,0.415,20,23,0.87,125,33,81,0.407,25,51,0.49,8,30,0.267,25,35,0.714,99
857,2021/1/9,SAC,POR,L 99-125,240,33,81,0.407,25,51,0.49,8,30,0.267,25,35,0.714,99,44,100,0.44,27,59,0.458,17,41,0.415,20,23,0.87,125
858,2021/1/9,MIA,WAS,W 128-124,240,46,93,0.495,30,50,0.6,16,43,0.372,20,26,0.769,128,44,99,0.444,29,59,0.492,15,40,0.375,21,28,0.75,124
859,2021/1/9,WAS,MIA,L 124-128,240,44,99,0.444,29,59,0.492,15,40,0.375,21,28,0.75,124,46,93,0.495,30,50,0.6,16,43,0.372,20,26,0.769,128
860,2021/1/8,BOS,WAS,W 116-107,240,41,86,0.477,29,54,0.537,12,32,0.375,22,30,0.733,116,41,88,0.466,30,59,0.508,11,29,0.379,14,16,0.875,107
861,2021/1/8,WAS,BOS,L 107-116,240,41,88,0.466,30,59,0.508,11,29,0.379,14,16,0.875,107,41,86,0.477,29,54,0.537,12,32,0.375,22,30,0.733,116
862,2021/1/8,DET,PHO,W 110-105 (OT),265,37,90,0.411,26,56,0.464,11,34,0.324,25,29,0.862,110,41,91,0.451,24,39,0.615,17,52,0.327,6,13,0.462,105
863,2021/1/8,PHO,DET,L 105-110 (OT),265,41,91,0.451,24,39,0.615,17,52,0.327,6,13,0.462,105,37,90,0.411,26,56,0.464,11,34,0.324,25,29,0.862,110
864,2021/1/8,GSW,LAC,W 115-105,240,40,82,0.488,20,41,0.488,20,41,0.488,15,18,0.833,115,40,83,0.482,26,52,0.5,14,31,0.452,11,13,0.846,105
865,2021/1/8,LAC,GSW,L 105-115,240,40,83,0.482,26,52,0.5,14,31,0.452,11,13,0.846,105,40,82,0.488,20,41,0.488,20,41,0.488,15,18,0.833,115
866,2021/1/8,HOU,ORL,W 132-90,240,51,91,0.56,29,44,0.659,22,47,0.468,8,11,0.727,132,34,89,0.382,26,60,0.433,8,29,0.276,14,16,0.875,90
867,2021/1/8,ORL,HOU,L 90-132,240,34,89,0.382,26,60,0.433,8,29,0.276,14,16,0.875,90,51,91,0.56,29,44,0.659,22,47,0.468,8,11,0.727,132
868,2021/1/8,CHI,LAL,L 115-117,240,46,91,0.505,36,65,0.554,10,26,0.385,13,14,0.929,115,41,81,0.506,29,52,0.558,12,29,0.414,23,27,0.852,117
869,2021/1/8,LAL,CHI,W 117-115,240,41,81,0.506,29,52,0.558,12,29,0.414,23,27,0.852,117,46,91,0.505,36,65,0.554,10,26,0.385,13,14,0.929,115
870,2021/1/8,BRK,MEM,L 110-115,240,38,81,0.469,24,50,0.48,14,31,0.452,20,21,0.952,110,45,98,0.459,32,66,0.485,13,32,0.406,12,14,0.857,115
871,2021/1/8,MEM,BRK,W 115-110,240,45,98,0.459,32,66,0.485,13,32,0.406,12,14,0.857,115,38,81,0.469,24,50,0.48,14,31,0.452,20,21,0.952,110
872,2021/1/8,MIL,UTA,L 118-131,240,44,98,0.449,31,56,0.554,13,42,0.31,17,21,0.81,118,49,97,0.505,24,44,0.545,25,53,0.472,8,13,0.615,131
873,2021/1/8,UTA,MIL,W 131-118,240,49,97,0.505,24,44,0.545,25,53,0.472,8,13,0.615,131,44,98,0.449,31,56,0.554,13,42,0.31,17,21,0.81,118
874,2021/1/8,CHO,NOP,W 118-110,240,41,87,0.471,25,45,0.556,16,42,0.381,20,25,0.8,118,38,77,0.494,23,39,0.59,15,38,0.395,19,26,0.731,110
875,2021/1/8,NOP,CHO,L 110-118,240,38,77,0.494,23,39,0.59,15,38,0.395,19,26,0.731,110,41,87,0.471,25,45,0.556,16,42,0.381,20,25,0.8,118
876,2021/1/8,NYK,OKC,L 89-101,240,34,96,0.354,25,69,0.362,9,27,0.333,12,20,0.6,89,38,87,0.437,27,53,0.509,11,34,0.324,14,21,0.667,101
877,2021/1/8,OKC,NYK,W 101-89,240,38,87,0.437,27,53,0.509,11,34,0.324,14,21,0.667,101,34,96,0.354,25,69,0.362,9,27,0.333,12,20,0.6,89
878,2021/1/8,SAC,TOR,L 123-144,240,46,81,0.568,31,47,0.66,15,34,0.441,16,28,0.571,123,53,91,0.582,33,52,0.635,20,39,0.513,18,22,0.818,144
879,2021/1/8,TOR,SAC,W 144-123,240,53,91,0.582,33,52,0.635,20,39,0.513,18,22,0.818,144,46,81,0.568,31,47,0.66,15,34,0.441,16,28,0.571,123
880,2021/1/7,BRK,PHI,W 122-109,240,44,97,0.454,29,60,0.483,15,37,0.405,19,29,0.655,122,41,87,0.471,32,61,0.525,9,26,0.346,18,20,0.9,109
881,2021/1/7,PHI,BRK,L 109-122,240,41,87,0.471,32,61,0.525,9,26,0.346,18,20,0.9,109,44,97,0.454,29,60,0.483,15,37,0.405,19,29,0.655,122
882,2021/1/7,DAL,DEN,W 124-117 (OT),265,42,87,0.483,26,47,0.553,16,40,0.4,24,31,0.774,124,43,97,0.443,28,53,0.528,15,44,0.341,16,21,0.762,117
883,2021/1/7,DEN,DAL,L 117-124 (OT),265,43,97,0.443,28,53,0.528,15,44,0.341,16,21,0.762,117,42,87,0.483,26,47,0.553,16,40,0.4,24,31,0.774,124
884,2021/1/7,LAL,SAS,L 109-118,240,43,86,0.5,33,56,0.589,10,30,0.333,13,21,0.619,109,43,92,0.467,27,57,0.474,16,35,0.457,16,17,0.941,118
885,2021/1/7,SAS,LAL,W 118-109,240,43,92,0.467,27,57,0.474,16,35,0.457,16,17,0.941,118,43,86,0.5,33,56,0.589,10,30,0.333,13,21,0.619,109
886,2021/1/7,CLE,MEM,W 94-90,240,36,79,0.456,23,49,0.469,13,30,0.433,9,16,0.563,94,36,83,0.434,25,52,0.481,11,31,0.355,7,8,0.875,90
887,2021/1/7,MEM,CLE,L 90-94,240,36,83,0.434,25,52,0.481,11,31,0.355,7,8,0.875,90,36,79,0.456,23,49,0.469,13,30,0.433,9,16,0.563,94
888,2021/1/7,MIN,POR,L 117-135,240,39,93,0.419,25,52,0.481,14,41,0.341,25,33,0.758,117,49,90,0.544,31,49,0.633,18,41,0.439,19,23,0.826,135
889,2021/1/7,POR,MIN,W 135-117,240,49,90,0.544,31,49,0.633,18,41,0.439,19,23,0.826,135,39,93,0.419,25,52,0.481,14,41,0.341,25,33,0.758,117
890,2021/1/6,ATL,CHO,L 94-102,240,36,96,0.375,29,56,0.518,7,40,0.175,15,18,0.833,94,32,85,0.376,21,49,0.429,11,36,0.306,27,33,0.818,102
891,2021/1/6,CHO,ATL,W 102-94,240,32,85,0.376,21,49,0.429,11,36,0.306,27,33,0.818,102,36,96,0.375,29,56,0.518,7,40,0.175,15,18,0.833,94
892,2021/1/6,GSW,LAC,L 101-108,240,39,86,0.453,31,56,0.554,8,30,0.267,15,19,0.789,101,36,81,0.444,25,47,0.532,11,34,0.324,25,25,1,108
893,2021/1/6,LAC,GSW,W 108-101,240,36,81,0.444,25,47,0.532,11,34,0.324,25,25,1,108,39,86,0.453,31,56,0.554,8,30,0.267,15,19,0.789,101
894,2021/1/6,HOU,IND,L 107-114,240,39,81,0.481,31,51,0.608,8,30,0.267,21,26,0.808,107,42,89,0.472,33,66,0.5,9,23,0.391,21,26,0.808,114
895,2021/1/6,IND,HOU,W 114-107,240,42,89,0.472,33,66,0.5,9,23,0.391,21,26,0.808,114,39,81,0.481,31,51,0.608,8,30,0.267,21,26,0.808,107
896,2021/1/6,BOS,MIA,W 107-105,240,42,99,0.424,30,64,0.469,12,35,0.343,11,12,0.917,107,35,81,0.432,22,45,0.489,13,36,0.361,22,26,0.846,105
897,2021/1/6,MIA,BOS,L 105-107,240,35,81,0.432,22,45,0.489,13,36,0.361,22,26,0.846,105,42,99,0.424,30,64,0.469,12,35,0.343,11,12,0.917,107
898,2021/1/6,DET,MIL,L 115-130,240,38,97,0.392,25,56,0.446,13,41,0.317,26,30,0.867,115,49,90,0.544,30,47,0.638,19,43,0.442,13,21,0.619,130
899,2021/1/6,MIL,DET,W 130-115,240,49,90,0.544,30,47,0.638,19,43,0.442,13,21,0.619,130,38,97,0.392,25,56,0.446,13,41,0.317,26,30,0.867,115
900,2021/1/6,NOP,OKC,L 110-111,240,44,89,0.494,40,67,0.597,4,22,0.182,18,23,0.783,110,40,87,0.46,21,41,0.512,19,46,0.413,12,16,0.75,111
901,2021/1/6,OKC,NOP,W 111-110,240,40,87,0.46,21,41,0.512,19,46,0.413,12,16,0.75,111,44,89,0.494,40,67,0.597,4,22,0.182,18,23,0.783,110
902,2021/1/6,NYK,UTA,W 112-100,240,45,87,0.517,37,65,0.569,8,22,0.364,14,19,0.737,112,40,91,0.44,26,47,0.553,14,44,0.318,6,11,0.545,100
903,2021/1/6,UTA,NYK,L 100-112,240,40,91,0.44,26,47,0.553,14,44,0.318,6,11,0.545,100,45,87,0.517,37,65,0.569,8,22,0.364,14,19,0.737,112
904,2021/1/6,CLE,ORL,L 94-105,240,36,85,0.424,32,59,0.542,4,26,0.154,18,26,0.692,94,40,81,0.494,28,52,0.538,12,29,0.414,13,18,0.722,105
905,2021/1/6,ORL,CLE,W 105-94,240,40,81,0.494,28,52,0.538,12,29,0.414,13,18,0.722,105,36,85,0.424,32,59,0.542,4,26,0.154,18,26,0.692,94
906,2021/1/6,PHI,WAS,W 141-136,240,50,81,0.617,32,52,0.615,18,29,0.621,23,33,0.697,141,47,94,0.5,31,57,0.544,16,37,0.432,26,35,0.743,136
907,2021/1/6,WAS,PHI,L 136-141,240,47,94,0.5,31,57,0.544,16,37,0.432,26,35,0.743,136,50,81,0.617,32,52,0.615,18,29,0.621,23,33,0.697,141
908,2021/1/6,PHO,TOR,W 123-115,240,40,83,0.482,19,43,0.442,21,40,0.525,22,24,0.917,123,39,79,0.494,25,44,0.568,14,35,0.4,23,32,0.719,115
909,2021/1/6,TOR,PHO,L 115-123,240,39,79,0.494,25,44,0.568,14,35,0.4,23,32,0.719,115,40,83,0.482,19,43,0.442,21,40,0.525,22,24,0.917,123
910,2021/1/6,CHI,SAC,L 124-128,240,49,93,0.527,35,53,0.66,14,40,0.35,12,15,0.8,124,47,91,0.516,33,54,0.611,14,37,0.378,20,27,0.741,128
911,2021/1/6,SAC,CHI,W 128-124,240,47,91,0.516,33,54,0.611,14,37,0.378,20,27,0.741,128,49,93,0.527,35,53,0.66,14,40,0.35,12,15,0.8,124
912,2021/1/5,BRK,UTA,W 130-96,240,52,93,0.559,38,57,0.667,14,36,0.389,12,16,0.75,130,33,86,0.384,22,52,0.423,11,34,0.324,19,27,0.704,96
913,2021/1/5,UTA,BRK,L 96-130,240,33,86,0.384,22,52,0.423,11,34,0.324,19,27,0.704,96,52,93,0.559,38,57,0.667,14,36,0.389,12,16,0.75,130
914,2021/1/5,DEN,MIN,W 123-116,240,41,79,0.519,33,54,0.611,8,25,0.32,33,45,0.733,123,42,91,0.462,31,57,0.544,11,34,0.324,21,27,0.778,116
915,2021/1/5,MIN,DEN,L 116-123,240,42,91,0.462,31,57,0.544,11,34,0.324,21,27,0.778,116,41,79,0.519,33,54,0.611,8,25,0.32,33,45,0.733,123
916,2021/1/5,LAC,SAS,L 113-116,240,43,86,0.5,28,51,0.549,15,35,0.429,12,13,0.923,113,44,96,0.458,24,56,0.429,20,40,0.5,8,11,0.727,116
917,2021/1/5,SAS,LAC,W 116-113,240,44,96,0.458,24,56,0.429,20,40,0.5,8,11,0.727,116,43,86,0.5,28,51,0.549,15,35,0.429,12,13,0.923,113
918,2021/1/5,LAL,MEM,W 94-92,240,38,87,0.437,29,56,0.518,9,31,0.29,9,11,0.818,94,36,87,0.414,26,61,0.426,10,26,0.385,10,13,0.769,92
919,2021/1/5,MEM,LAL,L 92-94,240,36,87,0.414,26,61,0.426,10,26,0.385,10,13,0.769,92,38,87,0.437,29,56,0.518,9,31,0.29,9,11,0.818,94
920,2021/1/5,CHI,POR,W 111-108,240,40,91,0.44,24,50,0.48,16,41,0.39,15,18,0.833,111,39,94,0.415,20,43,0.465,19,51,0.373,11,17,0.647,108
921,2021/1/5,POR,CHI,L 108-111,240,39,94,0.415,20,43,0.465,19,51,0.373,11,17,0.647,108,40,91,0.44,24,50,0.48,16,41,0.39,15,18,0.833,111
922,2021/1/4,ATL,NYK,L 108-113,240,40,87,0.46,30,56,0.536,10,31,0.323,18,23,0.783,108,43,85,0.506,36,64,0.563,7,21,0.333,20,25,0.8,113
923,2021/1/4,NYK,ATL,W 113-108,240,43,85,0.506,36,64,0.563,7,21,0.333,20,25,0.8,113,40,87,0.46,30,56,0.536,10,31,0.323,18,23,0.783,108
924,2021/1/4,GSW,SAC,W 137-106,240,51,97,0.526,28,54,0.519,23,43,0.535,12,14,0.857,137,34,90,0.378,24,55,0.436,10,35,0.286,28,39,0.718,106
925,2021/1/4,SAC,GSW,L 106-137,240,34,90,0.378,24,55,0.436,10,35,0.286,28,39,0.718,106,51,97,0.526,28,54,0.519,23,43,0.535,12,14,0.857,137
926,2021/1/4,DAL,HOU,W 113-100,240,39,82,0.476,23,43,0.535,16,39,0.41,19,20,0.95,113,30,77,0.39,19,37,0.514,11,40,0.275,29,36,0.806,100
927,2021/1/4,HOU,DAL,L 100-113,240,30,77,0.39,19,37,0.514,11,40,0.275,29,36,0.806,100,39,82,0.476,23,43,0.535,16,39,0.41,19,20,0.95,113
928,2021/1/4,MIA,OKC,W 118-90,240,46,81,0.568,30,47,0.638,16,34,0.471,10,18,0.556,118,29,79,0.367,16,31,0.516,13,48,0.271,19,27,0.704,90
929,2021/1/4,OKC,MIA,L 90-118,240,29,79,0.367,16,31,0.516,13,48,0.271,19,27,0.704,90,46,81,0.568,30,47,0.638,16,34,0.471,10,18,0.556,118
930,2021/1/4,DET,MIL,L 115-125,240,43,98,0.439,26,58,0.448,17,40,0.425,12,12,1,115,49,85,0.576,35,51,0.686,14,34,0.412,13,16,0.813,125
931,2021/1/4,MIL,DET,W 125-115,240,49,85,0.576,35,51,0.686,14,34,0.412,13,16,0.813,125,43,98,0.439,26,58,0.448,17,40,0.425,12,12,1,115
932,2021/1/4,IND,NOP,W 118-116 (OT),265,45,93,0.484,26,48,0.542,19,45,0.422,9,13,0.692,118,44,101,0.436,35,74,0.473,9,27,0.333,19,24,0.792,116
933,2021/1/4,NOP,IND,L 116-118 (OT),265,44,101,0.436,35,74,0.473,9,27,0.333,19,24,0.792,116,45,93,0.484,26,48,0.542,19,45,0.422,9,13,0.692,118
934,2021/1/4,CLE,ORL,L 83-103,240,33,85,0.388,23,57,0.404,10,28,0.357,7,12,0.583,83,38,88,0.432,23,54,0.426,15,34,0.441,12,13,0.923,103
935,2021/1/4,ORL,CLE,W 103-83,240,38,88,0.432,23,54,0.426,15,34,0.441,12,13,0.923,103,33,85,0.388,23,57,0.404,10,28,0.357,7,12,0.583,83
936,2021/1/4,CHO,PHI,L 101-118,240,36,86,0.419,23,47,0.489,13,39,0.333,16,22,0.727,101,46,95,0.484,35,63,0.556,11,32,0.344,15,23,0.652,118
937,2021/1/4,PHI,CHO,W 118-101,240,46,95,0.484,35,63,0.556,11,32,0.344,15,23,0.652,118,36,86,0.419,23,47,0.489,13,39,0.333,16,22,0.727,101
938,2021/1/4,BOS,TOR,W 126-114,240,41,84,0.488,26,55,0.473,15,29,0.517,29,34,0.853,126,36,90,0.4,23,53,0.434,13,37,0.351,29,38,0.763,114
939,2021/1/4,TOR,BOS,L 114-126,240,36,90,0.4,23,53,0.434,13,37,0.351,29,38,0.763,114,41,84,0.488,26,55,0.473,15,29,0.517,29,34,0.853,126
940,2021/1/3,BRK,WAS,L 122-123,240,40,81,0.494,26,49,0.531,14,32,0.438,28,31,0.903,122,43,104,0.413,31,71,0.437,12,33,0.364,25,34,0.735,123
941,2021/1/3,WAS,BRK,W 123-122,240,43,104,0.413,31,71,0.437,12,33,0.364,25,34,0.735,123,40,81,0.494,26,49,0.531,14,32,0.438,28,31,0.903,122
942,2021/1/3,CHI,DAL,W 118-108,240,39,85,0.459,26,48,0.542,13,37,0.351,27,30,0.9,118,39,89,0.438,28,47,0.596,11,42,0.262,19,27,0.704,108
943,2021/1/3,DAL,CHI,L 108-118,240,39,89,0.438,28,47,0.596,11,42,0.262,19,27,0.704,108,39,85,0.459,26,48,0.542,13,37,0.351,27,30,0.9,118
944,2021/1/3,BOS,DET,W 122-120,240,49,87,0.563,34,54,0.63,15,33,0.455,9,13,0.692,122,41,86,0.477,25,50,0.5,16,36,0.444,22,25,0.88,120
945,2021/1/3,DET,BOS,L 120-122,240,41,86,0.477,25,50,0.5,16,36,0.444,22,25,0.88,120,49,87,0.563,34,54,0.63,15,33,0.455,9,13,0.692,122
946,2021/1/3,GSW,POR,W 137-122,240,49,88,0.557,36,54,0.667,13,34,0.382,26,34,0.765,137,41,98,0.418,27,55,0.491,14,43,0.326,26,33,0.788,122
947,2021/1/3,POR,GSW,L 122-137,240,41,98,0.418,27,55,0.491,14,43,0.326,26,33,0.788,122,49,88,0.557,36,54,0.667,13,34,0.382,26,34,0.765,137
948,2021/1/3,LAL,MEM,W 108-94,240,41,89,0.461,29,54,0.537,12,35,0.343,14,19,0.737,108,39,95,0.411,30,62,0.484,9,33,0.273,7,8,0.875,94
949,2021/1/3,MEM,LAL,L 94-108,240,39,95,0.411,30,62,0.484,9,33,0.273,7,8,0.875,94,41,89,0.461,29,54,0.537,12,35,0.343,14,19,0.737,108
950,2021/1/3,DEN,MIN,W 124-109,240,45,92,0.489,26,47,0.553,19,45,0.422,15,21,0.714,124,44,85,0.518,34,54,0.63,10,31,0.323,11,16,0.688,109
951,2021/1/3,MIN,DEN,L 109-124,240,44,85,0.518,34,54,0.63,10,31,0.323,11,16,0.688,109,45,92,0.489,26,47,0.553,19,45,0.422,15,21,0.714,124
952,2021/1/3,LAC,PHO,W 112-107,240,40,83,0.482,23,54,0.426,17,29,0.586,15,19,0.789,112,37,75,0.493,27,42,0.643,10,33,0.303,23,28,0.821,107
953,2021/1/3,PHO,LAC,L 107-112,240,37,75,0.493,27,42,0.643,10,33,0.303,23,28,0.821,107,40,83,0.482,23,54,0.426,17,29,0.586,15,19,0.789,112
954,2021/1/3,SAS,UTA,L 109-130,240,44,105,0.419,38,86,0.442,6,19,0.316,15,21,0.714,109,49,89,0.551,28,48,0.583,21,41,0.512,11,19,0.579,130
955,2021/1/3,UTA,SAS,W 130-109,240,49,89,0.551,28,48,0.583,21,41,0.512,11,19,0.579,130,44,105,0.419,38,86,0.442,6,19,0.316,15,21,0.714,109
956,2021/1/2,ATL,CLE,L 91-96,240,35,85,0.412,24,53,0.453,11,32,0.344,10,19,0.526,91,38,91,0.418,31,62,0.5,7,29,0.241,13,17,0.765,96
957,2021/1/2,CLE,ATL,W 96-91,240,38,91,0.418,31,62,0.5,7,29,0.241,13,17,0.765,96,35,85,0.412,24,53,0.453,11,32,0.344,10,19,0.526,91
958,2021/1/2,HOU,SAC,W 102-94,240,36,81,0.444,23,40,0.575,13,41,0.317,17,23,0.739,102,35,90,0.389,26,62,0.419,9,28,0.321,15,21,0.714,94
959,2021/1/2,SAC,HOU,L 94-102,240,35,90,0.389,26,62,0.419,9,28,0.321,15,21,0.714,94,36,81,0.444,23,40,0.575,13,41,0.317,17,23,0.739,102
960,2021/1/2,IND,NYK,L 102-106,240,34,84,0.405,15,34,0.441,19,50,0.38,15,18,0.833,102,42,83,0.506,30,56,0.536,12,27,0.444,10,13,0.769,106
961,2021/1/2,NYK,IND,W 106-102,240,42,83,0.506,30,56,0.536,12,27,0.444,10,13,0.769,106,34,84,0.405,15,34,0.441,19,50,0.38,15,18,0.833,102
962,2021/1/2,NOP,TOR,W 120-116,240,35,83,0.422,21,45,0.467,14,38,0.368,36,47,0.766,120,38,91,0.418,24,43,0.558,14,48,0.292,26,27,0.963,116
963,2021/1/2,TOR,NOP,L 116-120,240,38,91,0.418,24,43,0.558,14,48,0.292,26,27,0.963,116,35,83,0.422,21,45,0.467,14,38,0.368,36,47,0.766,120
964,2021/1/2,OKC,ORL,W 108-99,240,38,86,0.442,25,45,0.556,13,41,0.317,19,21,0.905,108,40,108,0.37,30,70,0.429,10,38,0.263,9,12,0.75,99
965,2021/1/2,ORL,OKC,L 99-108,240,40,108,0.37,30,70,0.429,10,38,0.263,9,12,0.75,99,38,86,0.442,25,45,0.556,13,41,0.317,19,21,0.905,108
966,2021/1/2,CHO,PHI,L 112-127,240,38,92,0.413,25,57,0.439,13,35,0.371,23,26,0.885,112,47,79,0.595,31,44,0.705,16,35,0.457,17,24,0.708,127
967,2021/1/2,PHI,CHO,W 127-112,240,47,79,0.595,31,44,0.705,16,35,0.457,17,24,0.708,127,38,92,0.413,25,57,0.439,13,35,0.371,23,26,0.885,112
968,2021/1/1,ATL,BRK,W 114-96,240,43,93,0.462,27,54,0.5,16,39,0.41,12,14,0.857,114,35,86,0.407,28,49,0.571,7,37,0.189,19,23,0.826,96
969,2021/1/1,BRK,ATL,L 96-114,240,35,86,0.407,28,49,0.571,7,37,0.189,19,23,0.826,96,43,93,0.462,27,54,0.5,16,39,0.41,12,14,0.857,114
970,2021/1/1,CHO,MEM,L 93-108,240,35,86,0.407,26,55,0.473,9,31,0.29,14,21,0.667,93,43,90,0.478,29,51,0.569,14,39,0.359,8,10,0.8,108
971,2021/1/1,MEM,CHO,W 108-93,240,43,90,0.478,29,51,0.569,14,39,0.359,8,10,0.8,108,35,86,0.407,26,55,0.473,9,31,0.29,14,21,0.667,93
972,2021/1/1,DAL,MIA,W 93-83,240,32,78,0.41,20,41,0.488,12,37,0.324,17,23,0.739,93,29,78,0.372,22,45,0.489,7,33,0.212,18,25,0.72,83
973,2021/1/1,MIA,DAL,L 83-93,240,29,78,0.372,22,45,0.489,7,33,0.212,18,25,0.72,83,32,78,0.41,20,41,0.488,12,37,0.324,17,23,0.739,93
974,2021/1/1,DEN,PHO,L 103-106,240,39,86,0.453,27,57,0.474,12,29,0.414,13,16,0.813,103,37,76,0.487,24,41,0.585,13,35,0.371,19,21,0.905,106
975,2021/1/1,PHO,DEN,W 106-103,240,37,76,0.487,24,41,0.585,13,35,0.371,19,21,0.905,106,39,86,0.453,27,57,0.474,12,29,0.414,13,16,0.813,103
976,2021/1/1,BOS,DET,L 93-96,240,39,83,0.47,31,52,0.596,8,31,0.258,7,14,0.5,93,36,88,0.409,25,54,0.463,11,34,0.324,13,20,0.65,96
977,2021/1/1,DET,BOS,W 96-93,240,36,88,0.409,25,54,0.463,11,34,0.324,13,20,0.65,96,39,83,0.47,31,52,0.596,8,31,0.258,7,14,0.5,93
978,2021/1/1,GSW,POR,L 98-123,240,31,79,0.392,24,44,0.545,7,35,0.2,29,33,0.879,98,40,92,0.435,20,49,0.408,20,43,0.465,23,30,0.767,123
979,2021/1/1,POR,GSW,W 123-98,240,40,92,0.435,20,49,0.408,20,43,0.465,23,30,0.767,123,31,79,0.392,24,44,0.545,7,35,0.2,29,33,0.879,98
980,2021/1/1,CHI,MIL,L 96-126,240,38,87,0.437,32,61,0.525,6,26,0.231,14,20,0.7,96,42,85,0.494,20,40,0.5,22,45,0.489,20,30,0.667,126
981,2021/1/1,MIL,CHI,W 126-96,240,42,85,0.494,20,40,0.5,22,45,0.489,20,30,0.667,126,38,87,0.437,32,61,0.525,6,26,0.231,14,20,0.7,96
982,2021/1/1,MIN,WAS,L 109-130,240,42,88,0.477,29,52,0.558,13,36,0.361,12,21,0.571,109,49,89,0.551,33,56,0.589,16,33,0.485,16,21,0.762,130
983,2021/1/1,WAS,MIN,W 130-109,240,49,89,0.551,33,56,0.589,16,33,0.485,16,21,0.762,130,42,88,0.477,29,52,0.558,13,36,0.361,12,21,0.571,109
984,2021/1/1,LAL,SAS,W 109-103,240,41,101,0.406,27,68,0.397,14,33,0.424,13,16,0.813,109,36,85,0.424,23,51,0.451,13,34,0.382,18,26,0.692,103
985,2021/1/1,SAS,LAL,L 103-109,240,36,85,0.424,23,51,0.451,13,34,0.382,18,26,0.692,103,41,101,0.406,27,68,0.397,14,33,0.424,13,16,0.813,109
986,2021/1/1,LAC,UTA,L 100-106,240,33,85,0.388,20,52,0.385,13,33,0.394,21,24,0.875,100,41,89,0.461,26,47,0.553,15,42,0.357,9,14,0.643,106
987,2021/1/1,UTA,LAC,W 106-100,240,41,89,0.461,26,47,0.553,15,42,0.357,9,14,0.643,106,33,85,0.388,20,52,0.385,13,33,0.394,21,24,0.875,100
988,2020/12/31,HOU,SAC,W 122-119,240,45,86,0.523,32,50,0.64,13,36,0.361,19,25,0.76,122,45,96,0.469,34,63,0.54,11,33,0.333,18,24,0.75,119
989,2020/12/31,SAC,HOU,L 119-122,240,45,96,0.469,34,63,0.54,11,33,0.333,18,24,0.75,119,45,86,0.523,32,50,0.64,13,36,0.361,19,25,0.76,122
990,2020/12/31,CLE,IND,L 99-119,240,37,82,0.451,25,59,0.424,12,23,0.522,13,24,0.542,99,42,87,0.483,26,52,0.5,16,35,0.457,19,24,0.792,119
991,2020/12/31,IND,CLE,W 119-99,240,42,87,0.483,26,52,0.5,16,35,0.457,19,24,0.792,119,37,82,0.451,25,59,0.424,12,23,0.522,13,24,0.542,99
992,2020/12/31,NOP,OKC,W 113-80,240,44,91,0.484,31,55,0.564,13,36,0.361,12,19,0.632,113,30,80,0.375,15,32,0.469,15,48,0.313,5,15,0.333,80
993,2020/12/31,OKC,NOP,L 80-113,240,30,80,0.375,15,32,0.469,15,48,0.313,5,15,0.333,80,44,91,0.484,31,55,0.564,13,36,0.361,12,19,0.632,113
994,2020/12/31,ORL,PHI,L 92-116,240,33,95,0.347,26,67,0.388,7,28,0.25,19,21,0.905,92,44,91,0.484,29,58,0.5,15,33,0.455,13,15,0.867,116
995,2020/12/31,PHI,ORL,W 116-92,240,44,91,0.484,29,58,0.5,15,33,0.455,13,15,0.867,116,33,95,0.347,26,67,0.388,7,28,0.25,19,21,0.905,92
996,2020/12/31,NYK,TOR,L 83-100,240,32,88,0.364,29,52,0.558,3,36,0.083,16,20,0.8,83,34,83,0.41,17,31,0.548,17,52,0.327,15,21,0.714,100
997,2020/12/31,TOR,NYK,W 100-83,240,34,83,0.41,17,31,0.548,17,52,0.327,15,21,0.714,100,32,88,0.364,29,52,0.558,3,36,0.083,16,20,0.8,83
998,2020/12/31,PHO,UTA,W 106-95,240,41,84,0.488,24,51,0.471,17,33,0.515,7,10,0.7,106,35,84,0.417,23,50,0.46,12,34,0.353,13,19,0.684,95
999,2020/12/31,UTA,PHO,L 95-106,240,35,84,0.417,23,50,0.46,12,34,0.353,13,19,0.684,95,41,84,0.488,24,51,0.471,17,33,0.515,7,10,0.7,106
1000,2020/12/31,CHI,WAS,W 133-130,240,50,92,0.543,36,56,0.643,14,36,0.389,19,25,0.76,133,42,84,0.5,28,55,0.509,14,29,0.483,32,41,0.78,130
1001,2020/12/31,WAS,CHI,L 130-133,240,42,84,0.5,28,55,0.509,14,29,0.483,32,41,0.78,130,50,92,0.543,36,56,0.643,14,36,0.389,19,25,0.76,133
1002,2020/12/30,BOS,MEM,W 126-107,240,49,91,0.538,33,52,0.635,16,39,0.41,12,14,0.857,126,40,93,0.43,31,60,0.517,9,33,0.273,18,25,0.72,107
1003,2020/12/30,MEM,BOS,L 107-126,240,40,93,0.43,31,60,0.517,9,33,0.273,18,25,0.72,107,49,91,0.538,33,52,0.635,16,39,0.41,12,14,0.857,126
1004,2020/12/30,ATL,BRK,L 141-145,240,47,99,0.475,29,53,0.547,18,46,0.391,29,35,0.829,141,54,100,0.54,35,59,0.593,19,41,0.463,18,23,0.783,145
1005,2020/12/30,BRK,ATL,W 145-141,240,54,100,0.54,35,59,0.593,19,41,0.463,18,23,0.783,145,47,99,0.475,29,53,0.547,18,46,0.391,29,35,0.829,141
1006,2020/12/30,CHO,DAL,W 118-99,240,43,84,0.512,28,50,0.56,15,34,0.441,17,21,0.81,118,34,87,0.391,22,45,0.489,12,42,0.286,19,33,0.576,99
1007,2020/12/30,DAL,CHO,L 99-118,240,34,87,0.391,22,45,0.489,12,42,0.286,19,33,0.576,99,43,84,0.512,28,50,0.56,15,34,0.441,17,21,0.81,118
1008,2020/12/30,LAC,POR,W 128-105,240,47,95,0.495,29,57,0.509,18,38,0.474,16,22,0.727,128,32,76,0.421,20,38,0.526,12,38,0.316,29,34,0.853,105
1009,2020/12/30,POR,LAC,L 105-128,240,32,76,0.421,20,38,0.526,12,38,0.316,29,34,0.853,105,47,95,0.495,29,57,0.509,18,38,0.474,16,22,0.727,128
1010,2020/12/30,MIA,MIL,W 119-108,240,40,82,0.488,25,43,0.581,15,39,0.385,24,29,0.828,119,40,102,0.392,24,61,0.393,16,41,0.39,12,13,0.923,108
1011,2020/12/30,MIL,MIA,L 108-119,240,40,102,0.392,24,61,0.393,16,41,0.39,12,13,0.923,108,40,82,0.488,25,43,0.581,15,39,0.385,24,29,0.828,119
1012,2020/12/30,LAL,SAS,W 121-107,240,46,82,0.561,32,56,0.571,14,26,0.538,15,20,0.75,121,40,87,0.46,30,63,0.476,10,24,0.417,17,23,0.739,107
1013,2020/12/30,SAS,LAL,L 107-121,240,40,87,0.46,30,63,0.476,10,24,0.417,17,23,0.739,107,46,82,0.561,32,56,0.571,14,26,0.538,15,20,0.75,121
1014,2020/12/29,CLE,NYK,L 86-95,240,32,88,0.364,25,56,0.446,7,32,0.219,15,22,0.682,86,34,79,0.43,20,54,0.37,14,25,0.56,13,21,0.619,95
1015,2020/12/29,NYK,CLE,W 95-86,240,34,79,0.43,20,54,0.37,14,25,0.56,13,21,0.619,95,32,88,0.364,25,56,0.446,7,32,0.219,15,22,0.682,86
1016,2020/12/29,DET,GSW,L 106-116,240,35,92,0.38,22,57,0.386,13,35,0.371,23,29,0.793,106,38,76,0.5,24,43,0.558,14,33,0.424,26,36,0.722,116
1017,2020/12/29,GSW,DET,W 116-106,240,38,76,0.5,24,43,0.558,14,33,0.424,26,36,0.722,116,35,92,0.38,22,57,0.386,13,35,0.371,23,29,0.793,106
1018,2020/12/29,BOS,IND,W 116-111,240,40,80,0.5,31,58,0.534,9,22,0.409,27,37,0.73,116,43,84,0.512,31,51,0.608,12,33,0.364,13,16,0.813,111
1019,2020/12/29,IND,BOS,L 111-116,240,43,84,0.512,31,51,0.608,12,33,0.364,13,16,0.813,111,40,80,0.5,31,58,0.534,9,22,0.409,27,37,0.73,116
1020,2020/12/29,LAC,MIN,W 124-101,240,47,88,0.534,31,57,0.544,16,31,0.516,14,16,0.875,124,37,89,0.416,24,51,0.471,13,38,0.342,14,17,0.824,101
1021,2020/12/29,MIN,LAC,L 101-124,240,37,89,0.416,24,51,0.471,13,38,0.342,14,17,0.824,101,47,88,0.534,31,57,0.544,16,31,0.516,14,16,0.875,124
1022,2020/12/29,MIA,MIL,L 97-144,240,37,79,0.468,26,42,0.619,11,37,0.297,12,18,0.667,97,51,92,0.554,22,41,0.537,29,51,0.569,13,15,0.867,144
1023,2020/12/29,MIL,MIA,W 144-97,240,51,92,0.554,22,41,0.537,29,51,0.569,13,15,0.867,144,37,79,0.468,26,42,0.619,11,37,0.297,12,18,0.667,97
1024,2020/12/29,OKC,ORL,L 107-118,240,43,87,0.494,32,53,0.604,11,34,0.324,10,19,0.526,107,49,96,0.51,42,74,0.568,7,22,0.318,13,16,0.813,118
1025,2020/12/29,ORL,OKC,W 118-107,240,49,96,0.51,42,74,0.568,7,22,0.318,13,16,0.813,118,43,87,0.494,32,53,0.604,11,34,0.324,10,19,0.526,107
1026,2020/12/29,PHI,TOR,W 100-93,240,32,84,0.381,24,53,0.453,8,31,0.258,28,33,0.848,100,32,90,0.356,15,45,0.333,17,45,0.378,12,14,0.857,93
1027,2020/12/29,TOR,PHI,L 93-100,240,32,90,0.356,15,45,0.333,17,45,0.378,12,14,0.857,93,32,84,0.381,24,53,0.453,8,31,0.258,28,33,0.848,100
1028,2020/12/29,NOP,PHO,L 86-111,240,37,77,0.481,34,53,0.642,3,24,0.125,9,18,0.5,86,37,84,0.44,18,37,0.486,19,47,0.404,18,19,0.947,111
1029,2020/12/29,PHO,NOP,W 111-86,240,37,84,0.44,18,37,0.486,19,47,0.404,18,19,0.947,111,37,77,0.481,34,53,0.642,3,24,0.125,9,18,0.5,86
1030,2020/12/29,DEN,SAC,L 115-125,240,44,81,0.543,33,53,0.623,11,28,0.393,16,20,0.8,115,46,94,0.489,30,61,0.492,16,33,0.485,17,22,0.773,125
1031,2020/12/29,SAC,DEN,W 125-115,240,46,94,0.489,30,61,0.492,16,33,0.485,17,22,0.773,125,44,81,0.543,33,53,0.623,11,28,0.393,16,20,0.8,115
1032,2020/12/29,CHI,WAS,W 115-107,240,38,87,0.437,23,51,0.451,15,36,0.417,24,32,0.75,115,37,84,0.44,27,47,0.574,10,37,0.27,23,26,0.885,107
1033,2020/12/29,WAS,CHI,L 107-115,240,37,84,0.44,27,47,0.574,10,37,0.27,23,26,0.885,107,38,87,0.437,23,51,0.451,15,36,0.417,24,32,0.75,115
1034,2020/12/28,ATL,DET,W 128-120,240,40,82,0.488,20,40,0.5,20,42,0.476,28,32,0.875,128,43,98,0.439,30,57,0.526,13,41,0.317,21,24,0.875,120
1035,2020/12/28,DET,ATL,L 120-128,240,43,98,0.439,30,57,0.526,13,41,0.317,21,24,0.875,120,40,82,0.488,20,40,0.5,20,42,0.476,28,32,0.875,128
1036,2020/12/28,BRK,MEM,L 111-116 (OT),265,41,100,0.41,27,58,0.466,14,42,0.333,15,17,0.882,111,42,98,0.429,32,69,0.464,10,29,0.345,22,29,0.759,116
1037,2020/12/28,MEM,BRK,W 116-111 (OT),265,42,98,0.429,32,69,0.464,10,29,0.345,22,29,0.759,116,41,100,0.41,27,58,0.466,14,42,0.333,15,17,0.882,111
1038,2020/12/28,DEN,HOU,W 124-111,240,46,87,0.529,32,56,0.571,14,31,0.452,18,32,0.563,124,39,86,0.453,23,47,0.489,16,39,0.41,17,23,0.739,111
1039,2020/12/28,HOU,DEN,L 111-124,240,39,86,0.453,23,47,0.489,16,39,0.41,17,23,0.739,111,46,87,0.529,32,56,0.571,14,31,0.452,18,32,0.563,124
1040,2020/12/28,LAL,POR,L 107-115,240,41,87,0.471,31,60,0.517,10,27,0.37,15,18,0.833,107,43,92,0.467,27,46,0.587,16,46,0.348,13,15,0.867,115
1041,2020/12/28,POR,LAL,W 115-107,240,43,92,0.467,27,46,0.587,16,46,0.348,13,15,0.867,115,41,87,0.471,31,60,0.517,10,27,0.37,15,18,0.833,107
1042,2020/12/28,OKC,UTA,L 109-110,240,40,86,0.465,25,48,0.521,15,38,0.395,14,19,0.737,109,43,86,0.5,30,50,0.6,13,36,0.361,11,14,0.786,110
1043,2020/12/28,UTA,OKC,W 110-109,240,43,86,0.5,30,50,0.6,13,36,0.361,11,14,0.786,110,40,86,0.465,25,48,0.521,15,38,0.395,14,19,0.737,109
1044,2020/12/27,CHI,GSW,L 128-129,240,44,86,0.512,27,45,0.6,17,41,0.415,23,31,0.742,128,42,104,0.404,24,57,0.421,18,47,0.383,27,30,0.9,129
1045,2020/12/27,GSW,CHI,W 129-128,240,42,104,0.404,24,57,0.421,18,47,0.383,27,30,0.9,129,44,86,0.512,27,45,0.6,17,41,0.415,23,31,0.742,128
1046,2020/12/27,BRK,CHO,L 104-106,240,35,82,0.427,18,35,0.514,17,47,0.362,17,25,0.68,104,43,96,0.448,33,62,0.532,10,34,0.294,10,17,0.588,106
1047,2020/12/27,CHO,BRK,W 106-104,240,43,96,0.448,33,62,0.532,10,34,0.294,10,17,0.588,106,35,82,0.427,18,35,0.514,17,47,0.362,17,25,0.68,104
1048,2020/12/27,CLE,PHI,W 118-94,240,48,91,0.527,39,68,0.574,9,23,0.391,13,16,0.813,118,33,79,0.418,21,42,0.5,12,37,0.324,16,22,0.727,94
1049,2020/12/27,PHI,CLE,L 94-118,240,33,79,0.418,21,42,0.5,12,37,0.324,16,22,0.727,94,48,91,0.527,39,68,0.574,9,23,0.391,13,16,0.813,118
1050,2020/12/27,BOS,IND,L 107-108,240,40,79,0.506,31,56,0.554,9,23,0.391,18,24,0.75,107,45,88,0.511,38,62,0.613,7,26,0.269,11,15,0.733,108
1051,2020/12/27,IND,BOS,W 108-107,240,45,88,0.511,38,62,0.613,7,26,0.269,11,15,0.733,108,40,79,0.506,31,56,0.554,9,23,0.391,18,24,0.75,107
1052,2020/12/27,DAL,LAC,W 124-73,240,43,87,0.494,29,46,0.63,14,41,0.341,24,27,0.889,124,26,76,0.342,22,43,0.512,4,33,0.121,17,20,0.85,73
1053,2020/12/27,LAC,DAL,L 73-124,240,26,76,0.342,22,43,0.512,4,33,0.121,17,20,0.85,73,43,87,0.494,29,46,0.63,14,41,0.341,24,27,0.889,124
1054,2020/12/27,LAL,MIN,W 127-91,240,50,90,0.556,37,55,0.673,13,35,0.371,14,18,0.778,127,38,103,0.369,32,68,0.471,6,35,0.171,9,14,0.643,91
1055,2020/12/27,MIN,LAL,L 91-127,240,38,103,0.369,32,68,0.471,6,35,0.171,9,14,0.643,91,50,90,0.556,37,55,0.673,13,35,0.371,14,18,0.778,127
1056,2020/12/27,NOP,SAS,W 98-95,240,36,94,0.383,31,70,0.443,5,24,0.208,21,29,0.724,98,38,89,0.427,27,53,0.509,11,36,0.306,8,8,1,95
1057,2020/12/27,SAS,NOP,L 95-98,240,38,89,0.427,27,53,0.509,11,36,0.306,8,8,1,95,36,94,0.383,31,70,0.443,5,24,0.208,21,29,0.724,98
1058,2020/12/27,MIL,NYK,L 110-130,240,41,95,0.432,34,57,0.596,7,38,0.184,21,29,0.724,110,46,85,0.541,30,58,0.517,16,27,0.593,22,27,0.815,130
1059,2020/12/27,NYK,MIL,W 130-110,240,46,85,0.541,30,58,0.517,16,27,0.593,22,27,0.815,130,41,95,0.432,34,57,0.596,7,38,0.184,21,29,0.724,110
1060,2020/12/27,PHO,SAC,W 116-100,240,46,94,0.489,32,59,0.542,14,35,0.4,10,11,0.909,116,36,76,0.474,26,53,0.491,10,23,0.435,18,25,0.72,100
1061,2020/12/27,SAC,PHO,L 100-116,240,36,76,0.474,26,53,0.491,10,23,0.435,18,25,0.72,100,46,94,0.489,32,59,0.542,14,35,0.4,10,11,0.909,116
1062,2020/12/27,ORL,WAS,W 120-113,240,37,85,0.435,28,60,0.467,9,25,0.36,37,38,0.974,120,47,97,0.485,39,65,0.6,8,32,0.25,11,13,0.846,113
1063,2020/12/27,WAS,ORL,L 113-120,240,47,97,0.485,39,65,0.6,8,32,0.25,11,13,0.846,113,37,85,0.435,28,60,0.467,9,25,0.36,37,38,0.974,120
1064,2020/12/26,CHI,IND,L 106-125,240,34,91,0.374,18,52,0.346,16,39,0.41,22,25,0.88,106,52,93,0.559,43,67,0.642,9,26,0.346,12,19,0.632,125
1065,2020/12/26,IND,CHI,W 125-106,240,52,93,0.559,43,67,0.642,9,26,0.346,12,19,0.632,125,34,91,0.374,18,52,0.346,16,39,0.41,22,25,0.88,106
1066,2020/12/26,CHO,OKC,L 107-109,240,37,93,0.398,24,61,0.393,13,32,0.406,20,32,0.625,107,40,88,0.455,30,52,0.577,10,36,0.278,19,24,0.792,109
1067,2020/12/26,OKC,CHO,W 109-107,240,40,88,0.455,30,52,0.577,10,36,0.278,19,24,0.792,109,37,93,0.398,24,61,0.393,13,32,0.406,20,32,0.625,107
1068,2020/12/26,CLE,DET,W 128-119 (2OT),290,48,99,0.485,35,69,0.507,13,30,0.433,19,30,0.633,128,40,98,0.408,24,53,0.453,16,45,0.356,23,32,0.719,119
1069,2020/12/26,DET,CLE,L 119-128 (2OT),290,40,98,0.408,24,53,0.453,16,45,0.356,23,32,0.719,119,48,99,0.485,35,69,0.507,13,30,0.433,19,30,0.633,128
1070,2020/12/26,ATL,MEM,W 122-112,240,38,89,0.427,25,53,0.472,13,36,0.361,33,38,0.868,122,37,93,0.398,24,50,0.48,13,43,0.302,25,29,0.862,112
1071,2020/12/26,MEM,ATL,L 112-122,240,37,93,0.398,24,50,0.48,13,43,0.302,25,29,0.862,112,38,89,0.427,25,53,0.472,13,36,0.361,33,38,0.868,122
1072,2020/12/26,NYK,PHI,L 89-109,240,32,83,0.386,24,54,0.444,8,29,0.276,17,23,0.739,89,41,88,0.466,30,57,0.526,11,31,0.355,16,22,0.727,109
1073,2020/12/26,PHI,NYK,W 109-89,240,41,88,0.466,30,57,0.526,11,31,0.355,16,22,0.727,109,32,83,0.386,24,54,0.444,8,29,0.276,17,23,0.739,89
1074,2020/12/26,HOU,POR,L 126-128 (OT),265,45,87,0.517,34,52,0.654,11,35,0.314,25,32,0.781,126,47,102,0.461,28,57,0.491,19,45,0.422,15,23,0.652,128
1075,2020/12/26,POR,HOU,W 128-126 (OT),265,47,102,0.461,28,57,0.491,19,45,0.422,15,23,0.652,128,45,87,0.517,34,52,0.654,11,35,0.314,25,32,0.781,126
1076,2020/12/26,PHO,SAC,L 103-106,240,41,98,0.418,30,54,0.556,11,44,0.25,10,13,0.769,103,39,86,0.453,34,63,0.54,5,23,0.217,23,33,0.697,106
1077,2020/12/26,SAC,PHO,W 106-103,240,39,86,0.453,34,63,0.54,5,23,0.217,23,33,0.697,106,41,98,0.418,30,54,0.556,11,44,0.25,10,13,0.769,103
1078,2020/12/26,SAS,TOR,W 119-114,240,47,100,0.47,33,66,0.5,14,34,0.412,11,16,0.688,119,44,96,0.458,29,55,0.527,15,41,0.366,11,15,0.733,114
1079,2020/12/26,TOR,SAS,L 114-119,240,44,96,0.458,29,55,0.527,15,41,0.366,11,15,0.733,114,47,100,0.47,33,66,0.5,14,34,0.412,11,16,0.688,119
1080,2020/12/26,MIN,UTA,W 116-111,240,45,101,0.446,32,72,0.444,13,29,0.448,13,18,0.722,116,36,94,0.383,26,60,0.433,10,34,0.294,29,37,0.784,111
1081,2020/12/26,UTA,MIN,L 111-116,240,36,94,0.383,26,60,0.433,10,34,0.294,29,37,0.784,111,45,101,0.446,32,72,0.444,13,29,0.448,13,18,0.722,116
1082,2020/12/26,ORL,WAS,W 130-120,240,48,95,0.505,37,64,0.578,11,31,0.355,23,29,0.793,130,46,95,0.484,33,58,0.569,13,37,0.351,15,28,0.536,120
1083,2020/12/26,WAS,ORL,L 120-130,240,46,95,0.484,33,58,0.569,13,37,0.351,15,28,0.536,120,48,95,0.505,37,64,0.578,11,31,0.355,23,29,0.793,130
1084,2020/12/25,BOS,BRK,L 95-123,240,37,98,0.378,29,71,0.408,8,27,0.296,13,19,0.684,95,41,76,0.539,26,47,0.553,15,29,0.517,26,31,0.839,123
1085,2020/12/25,BRK,BOS,W 123-95,240,41,76,0.539,26,47,0.553,15,29,0.517,26,31,0.839,123,37,98,0.378,29,71,0.408,8,27,0.296,13,19,0.684,95
1086,2020/12/25,DEN,LAC,L 108-121,240,37,81,0.457,26,45,0.578,11,36,0.306,23,31,0.742,108,41,74,0.554,22,36,0.611,19,38,0.5,20,24,0.833,121
1087,2020/12/25,LAC,DEN,W 121-108,240,41,74,0.554,22,36,0.611,19,38,0.5,20,24,0.833,121,37,81,0.457,26,45,0.578,11,36,0.306,23,31,0.742,108
1088,2020/12/25,DAL,LAL,L 115-138,240,41,83,0.494,28,51,0.549,13,32,0.406,20,26,0.769,115,51,91,0.56,32,52,0.615,19,39,0.487,17,24,0.708,138
1089,2020/12/25,LAL,DAL,W 138-115,240,51,91,0.56,32,52,0.615,19,39,0.487,17,24,0.708,138,41,83,0.494,28,51,0.549,13,32,0.406,20,26,0.769,115
1090,2020/12/25,MIA,NOP,W 111-98,240,38,75,0.507,22,38,0.579,16,37,0.432,19,23,0.826,111,31,78,0.397,21,43,0.488,10,35,0.286,26,33,0.788,98
1091,2020/12/25,NOP,MIA,L 98-111,240,31,78,0.397,21,43,0.488,10,35,0.286,26,33,0.788,98,38,75,0.507,22,38,0.579,16,37,0.432,19,23,0.826,111
1092,2020/12/25,GSW,MIL,L 99-138,240,34,99,0.343,24,54,0.444,10,45,0.222,21,25,0.84,99,50,90,0.556,30,54,0.556,20,36,0.556,18,26,0.692,138
1093,2020/12/25,MIL,GSW,W 138-99,240,50,90,0.556,30,54,0.556,20,36,0.556,18,26,0.692,138,34,99,0.343,24,54,0.444,10,45,0.222,21,25,0.84,99
1094,2020/12/23,BOS,MIL,W 122-121,240,48,101,0.475,30,61,0.492,18,40,0.45,8,11,0.727,122,46,90,0.511,32,55,0.582,14,35,0.4,15,18,0.833,121
1095,2020/12/23,MIL,BOS,L 121-122,240,46,90,0.511,32,55,0.582,14,35,0.4,15,18,0.833,121,48,101,0.475,30,61,0.492,18,40,0.45,8,11,0.727,122
1096,2020/12/23,ATL,CHI,W 124-104,240,43,80,0.538,29,45,0.644,14,35,0.4,24,29,0.828,124,36,87,0.414,28,52,0.538,8,35,0.229,24,28,0.857,104
1097,2020/12/23,CHI,ATL,L 104-124,240,36,87,0.414,28,52,0.538,8,35,0.229,24,28,0.857,104,43,80,0.538,29,45,0.644,14,35,0.4,24,29,0.828,124
1098,2020/12/23,CHO,CLE,L 114-121,240,45,90,0.5,29,46,0.63,16,44,0.364,8,15,0.533,114,46,87,0.529,32,57,0.561,14,30,0.467,15,20,0.75,121
1099,2020/12/23,CLE,CHO,W 121-114,240,46,87,0.529,32,57,0.561,14,30,0.467,15,20,0.75,121,45,90,0.5,29,46,0.63,16,44,0.364,8,15,0.533,114
1100,2020/12/23,DEN,SAC,L 122-124 (OT),265,47,98,0.48,39,69,0.565,8,29,0.276,20,24,0.833,122,45,102,0.441,35,71,0.493,10,31,0.323,24,31,0.774,124
1101,2020/12/23,SAC,DEN,W 124-122 (OT),265,45,102,0.441,35,71,0.493,10,31,0.323,24,31,0.774,124,47,98,0.48,39,69,0.565,8,29,0.276,20,24,0.833,122
1102,2020/12/23,IND,NYK,W 121-107,240,46,94,0.489,38,60,0.633,8,34,0.235,21,29,0.724,121,39,85,0.459,27,57,0.474,12,28,0.429,17,23,0.739,107
1103,2020/12/23,NYK,IND,L 107-121,240,39,85,0.459,27,57,0.474,12,28,0.429,17,23,0.739,107,46,94,0.489,38,60,0.633,8,34,0.235,21,29,0.724,121
1104,2020/12/23,MEM,SAS,L 119-131,240,49,95,0.516,39,68,0.574,10,27,0.37,11,18,0.611,119,48,95,0.505,38,70,0.543,10,25,0.4,25,29,0.862,131
1105,2020/12/23,SAS,MEM,W 131-119,240,48,95,0.505,38,70,0.543,10,25,0.4,25,29,0.862,131,49,95,0.516,39,68,0.574,10,27,0.37,11,18,0.611,119
1106,2020/12/23,DET,MIN,L 101-111,240,45,93,0.484,37,58,0.638,8,35,0.229,3,8,0.375,101,38,88,0.432,27,47,0.574,11,41,0.268,24,28,0.857,111
1107,2020/12/23,MIN,DET,W 111-101,240,38,88,0.432,27,47,0.574,11,41,0.268,24,28,0.857,111,45,93,0.484,37,58,0.638,8,35,0.229,3,8,0.375,101
1108,2020/12/23,MIA,ORL,L 107-113,240,42,83,0.506,35,63,0.556,7,20,0.35,16,19,0.842,107,42,88,0.477,32,60,0.533,10,28,0.357,19,30,0.633,113
1109,2020/12/23,ORL,MIA,W 113-107,240,42,88,0.477,32,60,0.533,10,28,0.357,19,30,0.633,113,42,83,0.506,35,63,0.556,7,20,0.35,16,19,0.842,107
1110,2020/12/23,PHI,WAS,W 113-107,240,41,87,0.471,33,59,0.559,8,28,0.286,23,30,0.767,113,39,85,0.459,26,58,0.448,13,27,0.481,16,23,0.696,107
1111,2020/12/23,WAS,PHI,L 107-113,240,39,85,0.459,26,58,0.448,13,27,0.481,16,23,0.696,107,41,87,0.471,33,59,0.559,8,28,0.286,23,30,0.767,113
1112,2020/12/23,DAL,PHO,L 102-106,240,36,85,0.424,27,48,0.563,9,37,0.243,21,26,0.808,102,38,79,0.481,27,49,0.551,11,30,0.367,19,27,0.704,106
1113,2020/12/23,PHO,DAL,W 106-102,240,38,79,0.481,27,49,0.551,11,30,0.367,19,27,0.704,106,36,85,0.424,27,48,0.563,9,37,0.243,21,26,0.808,102
1114,2020/12/23,POR,UTA,L 100-120,240,37,92,0.402,25,59,0.424,12,33,0.364,14,17,0.824,100,43,94,0.457,24,44,0.545,19,50,0.38,15,19,0.789,120
1115,2020/12/23,UTA,POR,W 120-100,240,43,94,0.457,24,44,0.545,19,50,0.38,15,19,0.789,120,37,92,0.402,25,59,0.424,12,33,0.364,14,17,0.824,100
1116,2020/12/23,NOP,TOR,W 113-99,240,42,80,0.525,23,38,0.605,19,42,0.452,10,20,0.5,113,38,89,0.427,24,43,0.558,14,46,0.304,9,12,0.75,99
1117,2020/12/23,TOR,NOP,L 99-113,240,38,89,0.427,24,43,0.558,14,46,0.304,9,12,0.75,99,42,80,0.525,23,38,0.605,19,42,0.452,10,20,0.5,113
1118,2020/12/22,BRK,GSW,W 125-99,240,42,92,0.457,27,57,0.474,15,35,0.429,26,32,0.813,125,37,99,0.374,27,66,0.409,10,33,0.303,15,23,0.652,99
1119,2020/12/22,GSW,BRK,L 99-125,240,37,99,0.374,27,66,0.409,10,33,0.303,15,23,0.652,99,42,92,0.457,27,57,0.474,15,35,0.429,26,32,0.813,125
1120,2020/12/22,LAC,LAL,W 116-109,240,44,93,0.473,30,53,0.566,14,40,0.35,14,19,0.737,116,38,81,0.469,29,52,0.558,9,29,0.31,24,31,0.774,109
1121,2020/12/22,LAL,LAC,L 109-116,240,38,81,0.469,29,52,0.558,9,29,0.31,24,31,0.774,109,44,93,0.473,30,53,0.566,14,40,0.35,14,19,0.737,116
1122,2020/8/14,HOU,PHI,L 96-134,240,35,80,0.438,23,32,0.719,12,48,0.25,14,16,0.875,96,49,87,0.563,31,49,0.633,18,38,0.474,18,22,0.818,134
1123,2020/8/14,PHI,HOU,W 134-96,240,49,87,0.563,31,49,0.633,18,38,0.474,18,22,0.818,134,35,80,0.438,23,32,0.719,12,48,0.25,14,16,0.875,96
1124,2020/8/14,IND,MIA,W 109-92,240,43,89,0.483,28,51,0.549,15,38,0.395,8,11,0.727,109,31,87,0.356,21,49,0.429,10,38,0.263,20,27,0.741,92
1125,2020/8/14,MIA,IND,L 92-109,240,31,87,0.356,21,49,0.429,10,38,0.263,20,27,0.741,92,43,89,0.483,28,51,0.549,15,38,0.395,8,11,0.727,109
1126,2020/8/14,LAC,OKC,W 107-103 (OT),265,34,85,0.4,22,48,0.458,12,37,0.324,27,39,0.692,107,38,106,0.358,24,62,0.387,14,44,0.318,13,22,0.591,103
1127,2020/8/14,OKC,LAC,L 103-107 (OT),265,38,106,0.358,24,62,0.387,14,44,0.318,13,22,0.591,103,34,85,0.4,22,48,0.458,12,37,0.324,27,39,0.692,107
1128,2020/8/14,DEN,TOR,L 109-117,240,36,87,0.414,20,49,0.408,16,38,0.421,21,23,0.913,109,45,90,0.5,27,55,0.491,18,35,0.514,9,14,0.643,117
1129,2020/8/14,TOR,DEN,W 117-109,240,45,90,0.5,27,55,0.491,18,35,0.514,9,14,0.643,117,36,87,0.414,20,49,0.408,16,38,0.421,21,23,0.913,109
1130,2020/8/13,BOS,WAS,L 90-96,240,35,88,0.398,27,53,0.509,8,35,0.229,12,14,0.857,90,34,88,0.386,24,62,0.387,10,26,0.385,18,24,0.75,96
1131,2020/8/13,WAS,BOS,W 96-90,240,34,88,0.386,24,62,0.387,10,26,0.385,18,24,0.75,96,35,88,0.398,27,53,0.509,8,35,0.229,12,14,0.857,90
1132,2020/8/13,BRK,POR,L 133-134,240,53,96,0.552,39,63,0.619,14,33,0.424,13,19,0.684,133,50,104,0.481,37,65,0.569,13,39,0.333,21,24,0.875,134
1133,2020/8/13,POR,BRK,W 134-133,240,50,104,0.481,37,65,0.569,13,39,0.333,21,24,0.875,134,53,96,0.552,39,63,0.619,14,33,0.424,13,19,0.684,133
1134,2020/8/13,LAL,SAC,L 122-136,240,48,98,0.49,33,63,0.524,15,35,0.429,11,15,0.733,122,54,95,0.568,33,48,0.688,21,47,0.447,7,12,0.583,136
1135,2020/8/13,SAC,LAL,W 136-122,240,54,95,0.568,33,48,0.688,21,47,0.447,7,12,0.583,136,48,98,0.49,33,63,0.524,15,35,0.429,11,15,0.733,122
1136,2020/8/13,MEM,MIL,W 119-106,240,45,90,0.5,32,57,0.561,13,33,0.394,16,23,0.696,119,39,98,0.398,26,57,0.456,13,41,0.317,15,23,0.652,106
1137,2020/8/13,MIL,MEM,L 106-119,240,39,98,0.398,26,57,0.456,13,41,0.317,15,23,0.652,106,45,90,0.5,32,57,0.561,13,33,0.394,16,23,0.696,119
1138,2020/8/13,NOP,ORL,L 127-133,240,48,87,0.552,38,53,0.717,10,34,0.294,21,27,0.778,127,48,84,0.571,33,56,0.589,15,28,0.536,22,30,0.733,133
1139,2020/8/13,ORL,NOP,W 133-127,240,48,84,0.571,33,56,0.589,15,28,0.536,22,30,0.733,133,48,87,0.552,38,53,0.717,10,34,0.294,21,27,0.778,127
1140,2020/8/13,DAL,PHO,L 102-128,240,39,89,0.438,31,63,0.492,8,26,0.308,16,19,0.842,102,49,89,0.551,35,55,0.636,14,34,0.412,16,21,0.762,128
1141,2020/8/13,PHO,DAL,W 128-102,240,49,89,0.551,35,55,0.636,14,34,0.412,16,21,0.762,128,39,89,0.438,31,63,0.492,8,26,0.308,16,19,0.842,102
1142,2020/8/13,SAS,UTA,L 112-118,240,39,79,0.494,29,59,0.492,10,20,0.5,24,36,0.667,112,47,101,0.465,32,55,0.582,15,46,0.326,9,10,0.9,118
1143,2020/8/13,UTA,SAS,W 118-112,240,47,101,0.465,32,55,0.582,15,46,0.326,9,10,0.9,118,39,79,0.494,29,59,0.492,10,20,0.5,24,36,0.667,112
1144,2020/8/12,DEN,LAC,L 111-124,240,43,87,0.494,30,52,0.577,13,35,0.371,12,19,0.632,111,46,85,0.541,32,48,0.667,14,37,0.378,18,23,0.783,124
1145,2020/8/12,LAC,DEN,W 124-111,240,46,85,0.541,32,48,0.667,14,37,0.378,18,23,0.783,124,43,87,0.494,30,52,0.577,13,35,0.371,12,19,0.632,111
1146,2020/8/12,HOU,IND,L 104-108,240,32,86,0.372,16,29,0.552,16,57,0.281,24,28,0.857,104,40,100,0.4,29,69,0.42,11,31,0.355,17,22,0.773,108
1147,2020/8/12,IND,HOU,W 108-104,240,40,100,0.4,29,69,0.42,11,31,0.355,17,22,0.773,108,32,86,0.372,16,29,0.552,16,57,0.281,24,28,0.857,104
1148,2020/8/12,MIA,OKC,L 115-116,240,42,86,0.488,28,44,0.636,14,42,0.333,17,20,0.85,115,39,89,0.438,23,47,0.489,16,42,0.381,22,27,0.815,116
1149,2020/8/12,OKC,MIA,W 116-115,240,39,89,0.438,23,47,0.489,16,42,0.381,22,27,0.815,116,42,86,0.488,28,44,0.636,14,42,0.333,17,20,0.85,115
1150,2020/8/12,PHI,TOR,L 121-125,240,39,84,0.464,22,44,0.5,17,40,0.425,26,33,0.788,121,40,90,0.444,22,47,0.468,18,43,0.419,27,40,0.675,125
1151,2020/8/12,TOR,PHI,W 125-121,240,40,90,0.444,22,47,0.468,18,43,0.419,27,40,0.675,125,39,84,0.464,22,44,0.5,17,40,0.425,26,33,0.788,121
1152,2020/8/11,DAL,POR,L 131-134,240,42,81,0.519,22,37,0.595,20,44,0.455,27,33,0.818,131,46,98,0.469,31,60,0.517,15,38,0.395,27,29,0.931,134
1153,2020/8/11,POR,DAL,W 134-131,240,46,98,0.469,31,60,0.517,15,38,0.395,27,29,0.931,134,42,81,0.519,22,37,0.595,20,44,0.455,27,33,0.818,131
1154,2020/8/11,BOS,MEM,W 122-107,240,44,86,0.512,28,49,0.571,16,37,0.432,18,23,0.783,122,35,89,0.393,28,60,0.467,7,29,0.241,30,38,0.789,107
1155,2020/8/11,MEM,BOS,L 107-122,240,35,89,0.393,28,60,0.467,7,29,0.241,30,38,0.789,107,44,86,0.512,28,49,0.571,16,37,0.432,18,23,0.783,122
1156,2020/8/11,BRK,ORL,W 108-96,240,38,89,0.427,25,46,0.543,13,43,0.302,19,24,0.792,108,32,83,0.386,25,60,0.417,7,23,0.304,25,29,0.862,96
1157,2020/8/11,ORL,BRK,L 96-108,240,32,83,0.386,25,60,0.417,7,23,0.304,25,29,0.862,96,38,89,0.427,25,46,0.543,13,43,0.302,19,24,0.792,108
1158,2020/8/11,PHI,PHO,L 117-130,240,46,93,0.495,31,60,0.517,15,33,0.455,10,14,0.714,117,49,89,0.551,37,61,0.607,12,28,0.429,20,21,0.952,130
1159,2020/8/11,PHO,PHI,W 130-117,240,49,89,0.551,37,61,0.607,12,28,0.429,20,21,0.952,130,46,93,0.495,31,60,0.517,15,33,0.455,10,14,0.714,117
1160,2020/8/11,NOP,SAC,L 106-112,240,42,82,0.512,35,58,0.603,7,24,0.292,15,19,0.789,106,43,88,0.489,32,62,0.516,11,26,0.423,15,16,0.938,112
1161,2020/8/11,SAC,NOP,W 112-106,240,43,88,0.489,32,62,0.516,11,26,0.423,15,16,0.938,112,42,82,0.512,35,58,0.603,7,24,0.292,15,19,0.789,106
1162,2020/8/11,HOU,SAS,L 105-123,240,36,89,0.404,22,41,0.537,14,48,0.292,19,21,0.905,105,46,93,0.495,33,61,0.541,13,32,0.406,18,20,0.9,123
1163,2020/8/11,SAS,HOU,W 123-105,240,46,93,0.495,33,61,0.541,13,32,0.406,18,20,0.9,123,36,89,0.404,22,41,0.537,14,48,0.292,19,21,0.905,105
1164,2020/8/11,MIL,WAS,W 126-113,240,44,87,0.506,26,49,0.531,18,38,0.474,20,28,0.714,126,39,95,0.411,27,60,0.45,12,35,0.343,23,30,0.767,113
1165,2020/8/11,WAS,MIL,L 113-126,240,39,95,0.411,27,60,0.45,12,35,0.343,23,30,0.767,113,44,87,0.506,26,49,0.531,18,38,0.474,20,28,0.714,126
1166,2020/8/10,DEN,LAL,L 121-124,240,45,77,0.584,32,54,0.593,13,23,0.565,18,23,0.783,121,44,81,0.543,30,52,0.577,14,29,0.483,22,32,0.688,124
1167,2020/8/10,LAL,DEN,W 124-121,240,44,81,0.543,30,52,0.577,14,29,0.483,22,32,0.688,124,45,77,0.584,32,54,0.593,13,23,0.565,18,23,0.783,121
1168,2020/8/10,IND,MIA,L 92-114,240,33,84,0.393,23,49,0.469,10,35,0.286,16,25,0.64,92,44,98,0.449,31,58,0.534,13,40,0.325,13,19,0.684,114
1169,2020/8/10,MIA,IND,W 114-92,240,44,98,0.449,31,58,0.534,13,40,0.325,13,19,0.684,114,33,84,0.393,23,49,0.469,10,35,0.286,16,25,0.64,92
1170,2020/8/10,MIL,TOR,L 106-114,240,33,84,0.393,19,41,0.463,14,43,0.326,26,35,0.743,106,42,97,0.433,30,57,0.526,12,40,0.3,18,26,0.692,114
1171,2020/8/10,TOR,MIL,W 114-106,240,42,97,0.433,30,57,0.526,12,40,0.3,18,26,0.692,114,33,84,0.393,19,41,0.463,14,43,0.326,26,35,0.743,106
1172,2020/8/10,OKC,PHO,L 101-128,240,35,90,0.389,22,51,0.431,13,39,0.333,18,21,0.857,101,42,89,0.472,25,55,0.455,17,34,0.5,27,29,0.931,128
1173,2020/8/10,PHO,OKC,W 128-101,240,42,89,0.472,25,55,0.455,17,34,0.5,27,29,0.931,128,35,90,0.389,22,51,0.431,13,39,0.333,18,21,0.857,101
1174,2020/8/10,DAL,UTA,W 122-114,240,48,85,0.565,36,61,0.59,12,24,0.5,14,16,0.875,122,39,82,0.476,18,36,0.5,21,46,0.457,15,20,0.75,114
1175,2020/8/10,UTA,DAL,L 114-122,240,39,82,0.476,18,36,0.5,21,46,0.457,15,20,0.75,114,48,85,0.565,36,61,0.59,12,24,0.5,14,16,0.875,122
1176,2020/8/9,BOS,ORL,W 122-119 (OT),265,45,102,0.441,33,62,0.532,12,40,0.3,20,24,0.833,122,41,102,0.402,26,55,0.473,15,47,0.319,22,26,0.846,119
1177,2020/8/9,ORL,BOS,L 119-122 (OT),265,41,102,0.402,26,55,0.473,15,47,0.319,22,26,0.846,119,45,102,0.441,33,62,0.532,12,40,0.3,20,24,0.833,122
1178,2020/8/9,BRK,LAC,W 129-120,240,47,85,0.553,27,42,0.643,20,43,0.465,15,19,0.789,129,45,93,0.484,32,57,0.561,13,36,0.361,17,20,0.85,120
1179,2020/8/9,LAC,BRK,L 120-129,240,45,93,0.484,32,57,0.561,13,36,0.361,17,20,0.85,120,47,85,0.553,27,42,0.643,20,43,0.465,15,19,0.789,129
1180,2020/8/9,NOP,SAS,L 113-122,240,42,96,0.438,30,66,0.455,12,30,0.4,17,22,0.773,113,40,89,0.449,29,61,0.475,11,28,0.393,31,32,0.969,122
1181,2020/8/9,SAS,NOP,W 122-113,240,40,89,0.449,29,61,0.475,11,28,0.393,31,32,0.969,122,42,96,0.438,30,66,0.455,12,30,0.4,17,22,0.773,113
1182,2020/8/9,OKC,WAS,W 121-103,240,43,84,0.512,25,45,0.556,18,39,0.462,17,22,0.773,121,38,92,0.413,29,56,0.518,9,36,0.25,18,22,0.818,103
1183,2020/8/9,WAS,OKC,L 103-121,240,38,92,0.413,29,56,0.518,9,36,0.25,18,22,0.818,103,43,84,0.512,25,45,0.556,18,39,0.462,17,22,0.773,121
1184,2020/8/9,PHI,POR,L 121-124,240,47,97,0.485,33,67,0.493,14,30,0.467,13,17,0.765,121,43,91,0.473,32,56,0.571,11,35,0.314,27,29,0.931,124
1185,2020/8/9,POR,PHI,W 124-121,240,43,91,0.473,32,56,0.571,11,35,0.314,27,29,0.931,124,47,97,0.485,33,67,0.493,14,30,0.467,13,17,0.765,121
1186,2020/8/9,HOU,SAC,W 129-112,240,43,91,0.473,25,34,0.735,18,57,0.316,25,30,0.833,129,41,87,0.471,31,50,0.62,10,37,0.27,20,23,0.87,112
1187,2020/8/9,SAC,HOU,L 112-129,240,41,87,0.471,31,50,0.62,10,37,0.27,20,23,0.87,112,43,91,0.473,25,34,0.735,18,57,0.316,25,30,0.833,129
1188,2020/8/9,MEM,TOR,L 99-108,240,37,91,0.407,23,49,0.469,14,42,0.333,11,16,0.688,99,34,71,0.479,19,32,0.594,15,39,0.385,25,33,0.758,108
1189,2020/8/9,TOR,MEM,W 108-99,240,34,71,0.479,19,32,0.594,15,39,0.385,25,33,0.758,108,37,91,0.407,23,49,0.469,14,42,0.333,11,16,0.688,99
1190,2020/8/8,DAL,MIL,W 136-132 (OT),265,48,115,0.417,31,62,0.5,17,53,0.321,23,25,0.92,136,47,99,0.475,32,55,0.582,15,44,0.341,23,34,0.676,132
1191,2020/8/8,MIL,DAL,L 132-136 (OT),265,47,99,0.475,32,55,0.582,15,44,0.341,23,34,0.676,132,48,115,0.417,31,62,0.5,17,53,0.321,23,25,0.92,136
1192,2020/8/8,DEN,UTA,W 134-132 (2OT),290,51,108,0.472,42,71,0.592,9,37,0.243,23,30,0.767,134,47,105,0.448,25,50,0.5,22,55,0.4,16,22,0.727,132
1193,2020/8/8,UTA,DEN,L 132-134 (2OT),290,47,105,0.448,25,50,0.5,22,55,0.4,16,22,0.727,132,51,108,0.472,42,71,0.592,9,37,0.243,23,30,0.767,134
1194,2020/8/8,IND,LAL,W 116-111,240,44,84,0.524,29,51,0.569,15,33,0.455,13,14,0.929,116,42,100,0.42,29,61,0.475,13,39,0.333,14,19,0.737,111
1195,2020/8/8,LAL,IND,L 111-116,240,42,100,0.42,29,61,0.475,13,39,0.333,14,19,0.737,111,44,84,0.524,29,51,0.569,15,33,0.455,13,14,0.929,116
1196,2020/8/8,MIA,PHO,L 112-119,240,41,84,0.488,30,48,0.625,11,36,0.306,19,22,0.864,112,44,92,0.478,32,60,0.533,12,32,0.375,19,20,0.95,119
1197,2020/8/8,PHO,MIA,W 119-112,240,44,92,0.478,32,60,0.533,12,32,0.375,19,20,0.95,119,41,84,0.488,30,48,0.625,11,36,0.306,19,22,0.864,112
1198,2020/8/8,LAC,POR,W 122-117,240,42,85,0.494,27,51,0.529,15,34,0.441,23,28,0.821,122,44,90,0.489,27,47,0.574,17,43,0.395,12,17,0.706,117
1199,2020/8/8,POR,LAC,L 117-122,240,44,90,0.489,27,47,0.574,17,43,0.395,12,17,0.706,117,42,85,0.494,27,51,0.529,15,34,0.441,23,28,0.821,122
